,Name,Gender,Parliament,YOB,Parliament_Year,Age@Parliament,Age_buckets
0,"Sangha, Ramesh",M,43,1945,2019,74,71+
1,"Lefebvre, Paul",M,43,1968,2019,51,51-60
2,"Kmiec, Tom",M,43,1981,2019,38,31-40
3,"Leslie, Andrew",M,42,1957,2015,58,51-60
4,"Robillard, Yves",M,43,1936,2019,83,71+
5,"Easter, Wayne",M,42,1949,2015,66,61-70
6,"McKinnon, Ron",M,43,1951,2019,68,61-70
7,"Sopuck, Robert",M,42,1951,2015,64,61-70
8,"Vandal, Daniel",M,42,1960,2015,55,51-60
9,"Chiu, Kenny",M,43,1965,2019,54,51-60
10,"Duncan, Kirsty",F,43,1966,2019,53,51-60
11,"Rodriguez, Pablo",M,42,1967,2015,48,41-50
12,"Choquette, François",M,42,1974,2015,41,41-50
13,"Stubbs, Shannon",F,43,1979,2019,40,31-40
14,"Fraser, Sean",M,43,1984,2019,35,31-40
15,"Garrison, Randall",M,42,1951,2015,64,61-70
16,"Young, Terence H.",M,41,1952,2011,59,51-60
17,"Van Popta, Tako",M,43,1953,2019,66,61-70
18,"Williamson, John",M,41,1970,2011,41,41-50
19,"Wilson-Raybould, Jody",F,42,1971,2015,44,41-50
20,"Weir, Erin",M,42,1979,2015,36,31-40
21,"Atwin, Jenica",F,43,1984,2019,35,31-40
22,"Lightbound, Joël",M,42,1988,2015,27,18-30
23,"Badanai, Hubert",M,28,1895,1968,73,71+
24,"Diefenbaker, John George",M,28,1895,1968,73,71+
25,"MacDonald, Flora Isabel",F,33,1904,1984,80,71+
26,"Rynard, Philip Bernard",M,28,1897,1968,71,71+
27,"Flemming, Hugh John",M,28,1899,1968,69,61-70
28,"Michener, Daniel Roland",M,28,1900,1968,68,61-70
29,"Robillard, Yves",M,42,1936,2015,79,71+
30,"Charbonneau, Louise",F,43,1940,2019,79,71+
31,"Harris, Richard M.",M,40,1930,2008,78,71+
32,"Fry, Hedy",F,43,1941,2019,78,71+
33,"Hardie, Ken",M,43,1941,2019,78,71+
34,"Noble, Percy Verner",M,28,1902,1968,66,61-70
35,"Rochon, Jean-Léo",M,28,1902,1968,66,61-70
36,"Darling, Stan",M,34,1911,1988,77,71+
37,"Bratina, Bob",M,42,1938,2015,77,71+
38,"MacDonald, Flora Isabel",F,32,1904,1980,76,71+
39,"Harris, Richard M.",M,39,1930,2006,76,71+
40,"Williams, John G.",M,39,1932,2006,74,71+
41,"Kent, Peter",M,43,1943,2019,76,71+
42,"Plamondon, Louis",M,43,1943,2019,76,71+
43,"Cadieu, Albert C. (Bert)",M,28,1903,1968,65,61-70
44,"Harkness, Douglas Scott",M,28,1903,1968,65,61-70
45,"Casey, William D. (Bill)",M,34,1913,1988,75,71+
46,"Bratina, Bob",M,43,1944,2019,75,71+
47,"Sgro, Judy",F,43,1944,2019,75,71+
48,"Monteith, Jay Waldo",M,28,1903,1968,65,61-70
49,"Muir, George Robson",M,28,1903,1968,65,61-70
50,"Douglas, Thomas Clement (Tommy)",M,28,1904,1968,64,61-70
51,"Hees, George Harris",M,33,1910,1984,74,71+
52,"Taylor, Gordon Edward",M,33,1910,1984,74,71+
53,"Harris, Richard M.",M,38,1930,2004,74,71+
54,"Williams, John G.",M,38,1932,2004,72,71+
55,"Ouellet, Christian",M,40,1934,2008,74,71+
56,"Boughen, Ray",M,41,1937,2011,74,71+
57,"Fry, Hedy",F,42,1941,2015,74,71+
58,"Hardie, Ken",M,42,1941,2015,74,71+
59,"Tilson, David",M,42,1941,2015,74,71+
60,"Grills, Lee Elgy",M,28,1904,1968,64,61-70
61,"Noël, Aurélien",M,28,1904,1968,64,61-70
62,"MacInnis, Winona Grace",F,28,1905,1968,63,61-70
63,"Darling, Stan",M,33,1911,1984,73,71+
64,"McWhinney, Edward Watson (Ted)",M,36,1924,1997,73,71+
65,"Mercier, Paul",M,36,1924,1997,73,71+
66,"White, Ted",M,37,1931,2000,69,61-70
67,"Comuzzi, Joseph R. (Joe)",M,39,1933,2006,73,71+
68,"Bergen, Candice",F,43,1946,2019,73,71+
69,"MacAulay, Lawrence",M,43,1946,2019,73,71+
70,"MacKenzie, Dave",M,43,1946,2019,73,71+
71,"Howe, William Marvin",M,28,1906,1968,62,61-70
72,"Baldwin, Gerald William",M,28,1907,1968,61,61-70
73,"Knowles, Stanley Howard",M,32,1908,1980,72,71+
74,"Hamilton, Francis Alvin George",M,33,1912,1984,72,71+
75,"Bailey, Roy H.",M,37,1928,2000,72,71+
76,"Grose, Ivan",M,37,1928,2000,72,71+
77,"Lincoln, Clifford",M,37,1928,2000,72,71+
78,"Schmidt, Werner",M,38,1932,2004,72,71+
79,"Wayne, Elsie Eleanore",F,37,1932,2000,68,61-70
80,"Williams, John G.",M,37,1932,2000,68,61-70
81,"Ouellet, Christian",M,39,1934,2006,72,71+
82,"O'Connor, Gordon",M,41,1939,2011,72,71+
83,"Kent, Peter",M,42,1943,2015,72,71+
84,"Plamondon, Louis",M,42,1943,2015,72,71+
85,"Levitt, Michael",M,43,1947,2019,72,71+
86,"Brewin, Francis Andrew",M,28,1907,1968,61,61-70
87,"Richard, Jean-Thomas",M,28,1907,1968,61,61-70
88,"Southam, Richard Russell",M,28,1907,1968,61,61-70
89,"Winch, Harold Edward",M,28,1907,1968,61,61-70
90,"Cadieux, Léo Alphonse Joseph",M,28,1908,1968,60,51-60
91,"Duquet, Gérard",M,32,1909,1980,71,71+
92,"Finlay, John Baird",M,37,1929,2000,71,71+
93,"Comuzzi, Joseph R. (Joe)",M,38,1933,2004,71,71+
94,"Boughen, Ray",M,40,1937,2008,71,71+
95,"Cotler, Irwin",M,41,1940,2011,71,71+
96,"Oliver, Joe",M,41,1940,2011,71,71+
97,"St-Denis, Lise",F,41,1940,2011,71,71+
98,"Lauzon, Guy",M,42,1944,2015,71,71+
99,"Sgro, Judy",F,42,1944,2015,71,71+
100,"Harris, Jack",M,43,1948,2019,71,71+
101,"McKay, John",M,43,1948,2019,71,71+
102,"Shields, Martin",M,43,1948,2019,71,71+
103,"Wong, Alice",F,42,1948,2015,67,61-70
104,"Wong, Alice",F,43,1948,2019,71,71+
105,"Dionne, Charles-Eugène",M,28,1908,1968,60,51-60
106,"Knowles, Stanley Howard",M,28,1908,1968,60,51-60
107,"Knowles, William David",M,28,1908,1968,60,51-60
108,"Mongrain, Joseph-Alfred",M,28,1908,1968,60,51-60
109,"Tétrault, Oza",M,28,1908,1968,60,51-60
110,"Barnett, Thomas Speakman",M,28,1909,1968,59,51-60
111,"Duquet, Gérard",M,28,1909,1968,59,51-60
112,"Hales, Alfred Dryden",M,28,1909,1968,59,51-60
113,"Lewis, David",M,28,1909,1968,59,51-60
114,"Hees, George Harris",M,32,1910,1980,70,61-70
115,"Taylor, Gordon Edward",M,32,1910,1980,70,61-70
116,"Dumas, Maurice",M,36,1927,1997,70,61-70
117,"Caccia, Charles L.",M,37,1930,2000,70,61-70
118,"Harris, Richard M.",M,37,1930,2000,70,61-70
119,"Thompson, Myron",M,39,1936,2006,70,61-70
120,"Fry, Hedy",F,41,1941,2011,70,61-70
121,"Tilson, David",M,41,1941,2011,70,61-70
122,"Casey, William D. (Bill)",M,42,1945,2015,70,61-70
123,"Sangha, Ramesh",M,42,1945,2015,70,61-70
124,"Bagnell, Larry",M,43,1949,2019,70,61-70
125,"Duguid, Terry",M,43,1949,2019,70,61-70
126,"Easter, Wayne",M,43,1949,2019,70,61-70
127,"Finnigan, Pat",M,43,1949,2019,70,61-70
128,"Garneau, Marc",M,43,1949,2019,70,61-70
129,"Liepert, Ron",M,43,1949,2019,70,61-70
130,"Maguire, Larry",M,43,1949,2019,70,61-70
131,"Waugh, Kevin",M,42,1949,2015,66,61-70
132,"Waugh, Kevin",M,43,1949,2019,70,61-70
133,"Mather, Barry",M,28,1909,1968,59,51-60
134,"McIntosh, John (Jack)",M,28,1909,1968,59,51-60
135,"Ricard, J.-H.-Théogène",M,28,1909,1968,59,51-60
136,"Beer, Bruce Silas",M,28,1910,1968,58,51-60
137,"Darling, Stan",M,32,1911,1980,69,61-70
138,"Patterson, Alexander Bell",M,32,1911,1980,69,61-70
139,"Mitges, Constantine George (Gus)",M,34,1919,1988,69,61-70
140,"McWhinney, Edward Watson (Ted)",M,35,1924,1993,69,61-70
141,"Mercier, Paul",M,35,1924,1993,69,61-70
142,"Bailey, Roy H.",M,36,1928,1997,69,61-70
143,"Grose, Ivan",M,36,1928,1997,69,61-70
144,"Lincoln, Clifford",M,36,1928,1997,69,61-70
145,"Dromisky, Stanley Peter (Stan)",M,37,1931,2000,69,61-70
146,"Gray, Herbert Eser (Herb)",M,37,1931,2000,69,61-70
147,"White, Ted",M,36,1931,1997,66,61-70
148,"O'Connor, Gordon",M,40,1939,2008,69,61-70
149,"Fantino, Julian",M,41,1942,2011,69,61-70
150,"Turmel, Nycole",F,41,1942,2011,69,61-70
151,"Bergen, Candice",F,42,1946,2015,69,61-70
152,"Hogg, Gordie",M,42,1946,2015,69,61-70
153,"MacAulay, Lawrence",M,42,1946,2015,69,61-70
154,"MacKenzie, Dave",M,42,1946,2015,69,61-70
155,"Sidhu, Jati",M,42,1946,2015,69,61-70
156,"Bennett, Carolyn",F,43,1950,2019,69,61-70
157,"Jaczek, Helena",F,43,1950,2019,69,61-70
158,"Pauzé, Monique",F,43,1950,2019,69,61-70
159,"Van Bynen, Tony",M,43,1950,2019,69,61-70
160,"Warawa, Mark",M,42,1950,2015,65,61-70
161,"Hees, George Harris",M,28,1910,1968,58,51-60
162,"Pringle, M. Ervin",M,28,1910,1968,58,51-60
163,"Simpson, Robert",M,28,1910,1968,58,51-60
164,"Gleave, Alfred Pullen",M,28,1911,1968,57,51-60
165,"McQuaid, Melvin James",M,28,1911,1968,57,51-60
166,"Sharp, Mitchell William",M,28,1911,1968,57,51-60
167,"Walker, James Edgar",M,28,1911,1968,57,51-60
168,"Alkenbrack, Almonte Douglas",M,28,1912,1968,56,51-60
169,"Hamilton, Francis Alvin George",M,32,1912,1980,68,61-70
170,"Finlay, John Baird",M,36,1929,1997,68,61-70
171,"Bellemare, Eugène",M,37,1932,2000,68,61-70
172,"Richardson, John",M,37,1932,2000,68,61-70
173,"Schmidt, Werner",M,37,1932,2000,68,61-70
174,"Wayne, Elsie Eleanore",F,36,1932,1997,65,61-70
175,"Williams, John G.",M,36,1932,1997,65,61-70
176,"Adams, Peter",M,38,1936,2004,68,61-70
177,"Broadbent, John Edward",M,38,1936,2004,68,61-70
178,"Gagnon, Marcel",M,38,1936,2004,68,61-70
179,"Thompson, Myron",M,38,1936,2004,68,61-70
180,"Martin, Paul Edgar Philippe",M,39,1938,2006,68,61-70
181,"Cotler, Irwin",M,40,1940,2008,68,61-70
182,"Folco, Raymonde",F,40,1940,2008,68,61-70
183,"Lalonde, Francine",F,40,1940,2008,68,61-70
184,"Lévesque, Yvon",M,40,1940,2008,68,61-70
185,"Kent, Peter",M,41,1943,2011,68,61-70
186,"Plamondon, Louis",M,41,1943,2011,68,61-70
187,"Savoie, Denise",F,41,1943,2011,68,61-70
188,"Schellenberger, Gary",M,41,1943,2011,68,61-70
189,"Levitt, Michael",M,42,1947,2015,68,61-70
190,"Shipley, Bev",M,42,1947,2015,68,61-70
191,"Carr, Jim",M,43,1951,2019,68,61-70
192,"Garrison, Randall",M,43,1951,2019,68,61-70
193,"Lukiwski, Tom",M,43,1951,2019,68,61-70
194,"Ratansi, Yasmin",F,43,1951,2019,68,61-70
195,"Bigg, Frederick Johnstone (Jack)",M,28,1912,1968,56,51-60
196,"Blouin, Gustave",M,28,1912,1968,56,51-60
197,"Code, Desmond Morton",M,28,1912,1968,56,51-60
198,"Douglas, Albert B.",M,28,1912,1968,56,51-60
199,"Drury, Charles Mills (Bud)",M,28,1912,1968,56,51-60
200,"MacRae, John Chester",M,28,1912,1968,56,51-60
201,"McCutcheon, Maclyn (Mac) Thomas",M,28,1912,1968,56,51-60
202,"Smith, Walter Bernard",M,28,1912,1968,56,51-60
203,"Thomas, J. Antonio",M,28,1912,1968,56,51-60
204,"Clermont, Gaston",M,28,1913,1968,55,51-60
205,"McCain, Fred Alward",M,33,1917,1984,67,61-70
206,"McKinnon, Allan Bruce",M,33,1917,1984,67,61-70
207,"Reid, Joseph Lloyd",M,33,1917,1984,67,61-70
208,"Kempling, William James",M,34,1921,1988,67,61-70
209,"Scott, William C.",M,34,1921,1988,67,61-70
210,"Stupich, David",M,34,1921,1988,67,61-70
211,"Caccia, Charles L.",M,36,1930,1997,67,61-70
212,"Harris, Richard M.",M,36,1930,1997,67,61-70
213,"Comuzzi, Joseph R. (Joe)",M,37,1933,2000,67,61-70
214,"Leung, M. Sophia",F,37,1933,2000,67,61-70
215,"Augustine, Jean",F,38,1937,2004,67,61-70
216,"Cleary, Bernard",M,38,1937,2004,67,61-70
217,"Epp, Ken",M,39,1939,2006,67,61-70
218,"Graham, Bill",M,39,1939,2006,67,61-70
219,"O'Connor, Gordon",M,39,1939,2006,67,61-70
220,"Carrier, Robert",M,40,1941,2008,67,61-70
221,"Fry, Hedy",F,40,1941,2008,67,61-70
222,"Ménard, Serge",M,40,1941,2008,67,61-70
223,"Tilson, David",M,40,1941,2008,67,61-70
224,"Goldring, Peter",M,41,1944,2011,67,61-70
225,"Harris, Richard M.",M,41,1944,2011,67,61-70
226,"Lauzon, Guy",M,41,1944,2011,67,61-70
227,"Oda, Bev",F,41,1944,2011,67,61-70
228,"Sgro, Judy",F,41,1944,2011,67,61-70
229,"Eglinski, Jim",M,42,1948,2015,67,61-70
230,"McKay, John",M,42,1948,2015,67,61-70
231,"Shields, Martin",M,42,1948,2015,67,61-70
232,"Wong, Alice",F,41,1948,2011,63,61-70
233,"Kitchen, Robert Gordon",M,43,1952,2019,67,61-70
234,"Saroya, Bob",M,43,1952,2019,67,61-70
235,"Deachman, Grant",M,28,1913,1968,55,51-60
236,"Gauthier, Charles-Arthur",M,28,1913,1968,55,51-60
237,"Hymmen, Kieth Reinhardt",M,28,1913,1968,55,51-60
238,"Lambert, Joseph Adrien Henri",M,28,1913,1968,55,51-60
239,"Latulippe, Henry P.",M,28,1913,1968,55,51-60
240,"Lessard, H.-Pit",M,28,1913,1968,55,51-60
241,"Lind, James (Jim) Gordon",M,28,1913,1968,55,51-60
242,"Émard, René",M,28,1914,1968,54,51-60
243,"Gundlock, Deane Roscoe",M,28,1914,1968,54,51-60
244,"Harding, Randolph",M,28,1914,1968,54,51-60
245,"Kierans, Eric William",M,28,1914,1968,54,51-60
246,"L'Heureux, Yvon",M,28,1914,1968,54,51-60
247,"MacLean, John Angus",M,28,1914,1968,54,51-60
248,"Moore, Harry Andrew",M,28,1914,1968,54,51-60
249,"Smerchanski, Mark G.",M,28,1914,1968,54,51-60
250,"Crouse, Lloyd Roseville",M,33,1918,1984,66,61-70
251,"Orlikow, David",M,33,1918,1984,66,61-70
252,"Anderson, Edna",F,34,1922,1988,66,61-70
253,"Sauvé, Jeanne",F,34,1922,1988,66,61-70
254,"Van De Walle, Walter",M,34,1922,1988,66,61-70
255,"Dumas, Maurice",M,35,1927,1993,66,61-70
256,"Dromisky, Stanley Peter (Stan)",M,36,1931,1997,66,61-70
257,"Gray, Herbert Eser (Herb)",M,36,1931,1997,66,61-70
258,"Jones, Jim",M,36,1931,1997,66,61-70
259,"Sekora, Lou",M,36,1931,1997,66,61-70
260,"White, Ted",M,35,1931,1993,62,61-70
261,"Bachand, André",M,37,1934,2000,66,61-70
262,"Bachand, André",M,37,1934,2000,66,61-70
263,"Chrétien, Joseph Jacques Jean",M,37,1934,2000,66,61-70
264,"Martin, Paul Edgar Philippe",M,38,1938,2004,66,61-70
265,"Phinney, Elizabeth  (Beth)",F,38,1938,2004,66,61-70
266,"Cotler, Irwin",M,39,1940,2006,66,61-70
267,"Folco, Raymonde",F,39,1940,2006,66,61-70
268,"Hubbard, Charles",M,39,1940,2006,66,61-70
269,"Lalonde, Francine",F,39,1940,2006,66,61-70
270,"Lévesque, Yvon",M,39,1940,2006,66,61-70
271,"Perron, Gilles-A.",M,39,1940,2006,66,61-70
272,"Abbott, Jim",M,40,1942,2008,66,61-70
273,"Cummins, John Martin",M,40,1942,2008,66,61-70
274,"Dorion, Jean",M,40,1942,2008,66,61-70
275,"Fantino, Julian",M,40,1942,2008,66,61-70
276,"Neville, Anita",F,40,1942,2008,66,61-70
277,"Savage, Michael John",M,40,1942,2008,66,61-70
278,"Atamanenko, Alex",M,41,1945,2011,66,61-70
279,"Breitkreuz, Garry W.",M,41,1945,2011,66,61-70
280,"Payne, LaVar",M,41,1945,2011,66,61-70
281,"Raynault, Francine",F,41,1945,2011,66,61-70
282,"Albrecht, Harold",M,42,1949,2015,66,61-70
283,"Bagnell, Larry",M,42,1949,2015,66,61-70
284,"Duguid, Terry",M,42,1949,2015,66,61-70
285,"Duncan, Linda Francis",F,42,1949,2015,66,61-70
286,"Finnigan, Pat",M,42,1949,2015,66,61-70
287,"Garneau, Marc",M,42,1949,2015,66,61-70
288,"Goodale, Ralph",M,42,1949,2015,66,61-70
289,"Liepert, Ron",M,42,1949,2015,66,61-70
290,"Maguire, Larry",M,42,1949,2015,66,61-70
291,"Paradis, Denis",M,42,1949,2015,66,61-70
292,"Arnold, Mel",M,43,1953,2019,66,61-70
293,"Dreeshen, Earl",M,43,1953,2019,66,61-70
294,"McCrimmon, Karen",F,43,1953,2019,66,61-70
295,"Motz, Glen",M,43,1953,2019,66,61-70
296,"Rogers, Churence",M,43,1953,2019,66,61-70
297,"Stanfield, Robert Lorne",M,28,1914,1968,54,51-60
298,"Thompson, Robert Norman",M,28,1914,1968,54,51-60
299,"Barrett, H. Gordon",M,28,1915,1968,53,51-60
300,"Crossman, Guy F.",M,28,1915,1968,53,51-60
301,"Éthier, Viateur",M,28,1915,1968,53,51-60
302,"Major, Robert Benoit",M,28,1915,1968,53,51-60
303,"Chappell, Hyliard G.",M,28,1916,1968,52,51-60
304,"Danforth, Harold Warren",M,28,1916,1968,52,51-60
305,"Davis, John (Jack)",M,28,1916,1968,52,51-60
306,"Dinsdale, Walter Gilbert",M,28,1916,1968,52,51-60
307,"Forget, Victor",M,28,1916,1968,52,51-60
308,"O'Connell, Martin Patrick",M,28,1916,1968,52,51-60
309,"Thomas, Charles Humbert",M,28,1916,1968,52,51-60
310,"Wahn, Ian Grant",M,28,1916,1968,52,51-60
311,"Woolliams, Eldon Mattison",M,28,1916,1968,52,51-60
312,"Caouette, David Réal",M,28,1917,1968,51,51-60
313,"Aiken, Gordon Harvey",M,28,1918,1968,50,41-50
314,"Boulanger, Prosper",M,28,1918,1968,50,41-50
315,"Mitges, Constantine George (Gus)",M,33,1919,1984,65,61-70
316,"Towers, Thomas Gordon",M,33,1919,1984,65,61-70
317,"Bertrand, Gabrielle",F,34,1923,1988,65,61-70
318,"Porter, Robert Harold",M,34,1923,1988,65,61-70
319,"Grose, Ivan",M,35,1928,1993,65,61-70
320,"Jordan, Jim",M,35,1928,1993,65,61-70
321,"Lincoln, Clifford",M,35,1928,1993,65,61-70
322,"Ringma, Robert  (Bob)",M,35,1928,1993,65,61-70
323,"Bellemare, Eugène",M,36,1932,1997,65,61-70
324,"Godin, Maurice",M,36,1932,1997,65,61-70
325,"Morrison, Lee Glen",M,36,1932,1997,65,61-70
326,"Richardson, John",M,36,1932,1997,65,61-70
327,"Schmidt, Werner",M,36,1932,1997,65,61-70
328,"Williams, John G.",M,35,1932,1993,61,61-70
329,"Pagtakhan, Rey D.",M,37,1935,2000,65,61-70
330,"Catterall, Marlene",F,38,1939,2004,65,61-70
331,"Epp, Ken",M,38,1939,2004,65,61-70
332,"Graham, Bill",M,38,1939,2004,65,61-70
333,"O'Connor, Gordon",M,38,1939,2004,65,61-70
334,"Barbot, Vivian",F,39,1941,2006,65,61-70
335,"Brown, Bonnie",F,39,1941,2006,65,61-70
336,"Carrier, Robert",M,39,1941,2006,65,61-70
337,"Fry, Hedy",F,39,1941,2006,65,61-70
338,"Ménard, Serge",M,39,1941,2006,65,61-70
339,"Mills, Robert (Bob)",M,39,1941,2006,65,61-70
340,"Peterson, James Scott (Jim)",M,39,1941,2006,65,61-70
341,"Tilson, David",M,39,1941,2006,65,61-70
342,"Arthur, André",M,40,1943,2008,65,61-70
343,"Black, Dawn",F,40,1943,2008,65,61-70
344,"Bouchard, Robert",M,40,1943,2008,65,61-70
345,"Kent, Peter",M,40,1943,2008,65,61-70
346,"Lessard, Yves",M,40,1943,2008,65,61-70
347,"Patry, Bernard",M,40,1943,2008,65,61-70
348,"Plamondon, Louis",M,40,1943,2008,65,61-70
349,"Savoie, Denise",F,40,1943,2008,65,61-70
350,"Schellenberger, Gary",M,40,1943,2008,65,61-70
351,"Tonks, Alan",M,40,1943,2008,65,61-70
352,"Bergen, Candice",F,41,1946,2011,65,61-70
353,"Davidson, Patricia",F,41,1946,2011,65,61-70
354,"Genest, Réjean",M,41,1946,2011,65,61-70
355,"Hyer, Bruce",M,41,1946,2011,65,61-70
356,"MacAulay, Lawrence",M,41,1946,2011,65,61-70
357,"MacKenzie, Dave",M,41,1946,2011,65,61-70
358,"Bennett, Carolyn",F,42,1950,2015,65,61-70
359,"McCallum, John",M,42,1950,2015,65,61-70
360,"Obhrai, Deepak",M,42,1950,2015,65,61-70
361,"Pauzé, Monique",F,42,1950,2015,65,61-70
362,"Rankin, Murray",M,42,1950,2015,65,61-70
363,"Warawa, Mark",M,41,1950,2011,61,61-70
364,"Blair, Bill",M,43,1954,2019,65,61-70
365,"Cannings, Richard",M,43,1954,2019,65,61-70
366,"Lehoux, Richard",M,43,1954,2019,65,61-70
367,"May, Elizabeth",F,43,1954,2019,65,61-70
368,"McColeman, Phil",M,43,1954,2019,65,61-70
369,"Morrissey, Robert",M,43,1954,2019,65,61-70
370,"Murray, Joyce",F,43,1954,2019,65,61-70
371,"Schulte, Deborah",F,43,1954,2019,65,61-70
372,"Cantin, Jean-Charles",M,28,1918,1968,50,41-50
373,"Crouse, Lloyd Roseville",M,28,1918,1968,50,41-50
374,"Groos, David Walter",M,28,1918,1968,50,41-50
375,"MacInnis, Donald",M,28,1918,1968,50,41-50
376,"McNulty, James Carroll Patrick",M,28,1918,1968,50,41-50
377,"Nesbitt, Wallace Bickford (Wally)",M,28,1918,1968,50,41-50
378,"Orlikow, David",M,28,1918,1968,50,41-50
379,"Dinsdale, Walter Gilbert",M,32,1916,1980,64,61-70
380,"Hudecki, Stanley",M,32,1916,1980,64,61-70
381,"Munro, Donald W.",M,32,1916,1980,64,61-70
382,"Isabelle, Joseph Gaston",M,33,1920,1984,64,61-70
383,"Winegard, William C.",M,34,1924,1988,64,61-70
384,"Finlay, John Baird",M,35,1929,1993,64,61-70
385,"Loney, Edison John Clayton",M,35,1929,1993,64,61-70
386,"Comuzzi, Joseph R. (Joe)",M,36,1933,1997,64,61-70
387,"Leung, M. Sophia",F,36,1933,1997,64,61-70
388,"Adams, Peter",M,37,1936,2000,64,61-70
389,"Gagnon, Marcel",M,37,1936,2000,64,61-70
390,"Pillitteri, Gary Orazio Vincenzo",M,37,1936,2000,64,61-70
391,"Reed, Julian Alexander Arnott",M,37,1936,2000,64,61-70
392,"Thompson, Myron",M,37,1936,2000,64,61-70
393,"Cotler, Irwin",M,38,1940,2004,64,61-70
394,"Folco, Raymonde",F,38,1940,2004,64,61-70
395,"Hubbard, Charles",M,38,1940,2004,64,61-70
396,"Lalonde, Francine",F,38,1940,2004,64,61-70
397,"Lastewka, Walt",M,38,1940,2004,64,61-70
398,"Lévesque, Yvon",M,38,1940,2004,64,61-70
399,"Perron, Gilles-A.",M,38,1940,2004,64,61-70
400,"Pickard, Jerry",M,38,1940,2004,64,61-70
401,"Wood, Bob",M,37,1940,2000,60,51-60
402,"Abbott, Jim",M,39,1942,2006,64,61-70
403,"Bell, Don",M,39,1942,2006,64,61-70
404,"Bonin, Raymond",M,39,1942,2006,64,61-70
405,"Cummins, John Martin",M,39,1942,2006,64,61-70
406,"Godfrey, John Ferguson",M,39,1942,2006,64,61-70
407,"Neville, Anita",F,39,1942,2006,64,61-70
408,"Savage, Michael John",M,39,1942,2006,64,61-70
409,"Steckle, Paul Daniel",M,39,1942,2006,64,61-70
410,"Goldring, Peter",M,40,1944,2008,64,61-70
411,"Lauzon, Guy",M,40,1944,2008,64,61-70
412,"Oda, Bev",F,40,1944,2008,64,61-70
413,"Sgro, Judy",F,40,1944,2008,64,61-70
414,"Comartin, Joe",M,41,1947,2011,64,61-70
415,"Galipeau, Joseph Bernard Royal Neil",M,41,1947,2011,64,61-70
416,"Hawn, Laurie",M,41,1947,2011,64,61-70
417,"Kerr, Greg",M,41,1947,2011,64,61-70
418,"Kramp, Daryl",M,41,1947,2011,64,61-70
419,"Marston, Wayne",M,41,1947,2011,64,61-70
420,"Richardson, Lee",M,41,1947,2011,64,61-70
421,"Shipley, Bev",M,41,1947,2011,64,61-70
422,"Smith, Joy",F,41,1947,2011,64,61-70
423,"Volpe, Giuseppe (Joseph)",M,40,1947,2008,61,61-70
424,"Carr, Jim",M,42,1951,2015,64,61-70
425,"Kang, Darshan Singh",M,42,1951,2015,64,61-70
426,"Lukiwski, Tom",M,42,1951,2015,64,61-70
427,"Mathyssen, Irene",F,42,1951,2015,64,61-70
428,"McKinnon, Ron",M,42,1951,2015,64,61-70
429,"Ratansi, Yasmin",F,42,1951,2015,64,61-70
430,"Ritz, Gerry",M,42,1951,2015,64,61-70
431,"Chabot, Louise",F,43,1955,2019,64,61-70
432,"El-Khoury, Fayçal",M,43,1955,2019,64,61-70
433,"Fast, Edward",M,43,1955,2019,64,61-70
434,"Findlay, Kerry-Lynne D.",F,43,1955,2019,64,61-70
435,"Pilon, J.-E. Bernard",M,28,1918,1968,50,41-50
436,"Ritchie, William Gordon",M,28,1918,1968,50,41-50
437,"Ryan, Sylvester Perry",M,28,1918,1968,50,41-50
438,"Whicher, Ross Mackenzie",M,28,1918,1968,50,41-50
439,"Blair, Duncan Gordon",M,28,1919,1968,49,41-50
440,"Lambert, Marcel Joseph Aimé",M,28,1919,1968,49,41-50
441,"Osler, Edmund Boyd",M,28,1919,1968,49,41-50
442,"Pelletier, Gérard",M,28,1919,1968,49,41-50
443,"Trudeau, Pierre Elliott",M,28,1919,1968,49,41-50
444,"Trudel, Jacques L.",M,28,1919,1968,49,41-50
445,"Francis, Cyril Lloyd",M,28,1920,1968,48,41-50
446,"Gendron, Rosaire",M,28,1920,1968,48,41-50
447,"Isabelle, Joseph Gaston",M,28,1920,1968,48,41-50
448,"Lamoureux, Lucien",M,28,1920,1968,48,41-50
449,"Sullivan, Gordon Joseph",M,28,1920,1968,48,41-50
450,"Andras, Robert Knight",M,28,1921,1968,47,41-50
451,"Danson, Barnett Jerome",M,28,1921,1968,47,41-50
452,"Hargrave, Herbert Thomas (Bert)",M,32,1917,1980,63,61-70
453,"McCain, Fred Alward",M,32,1917,1980,63,61-70
454,"McKinnon, Allan Bruce",M,32,1917,1980,63,61-70
455,"Reid, Joseph Lloyd",M,32,1917,1980,63,61-70
456,"Kempling, William James",M,33,1921,1984,63,61-70
457,"Scott, William C.",M,33,1921,1984,63,61-70
458,"Benjamin, Leslie Gordon",M,34,1925,1988,63,61-70
459,"Heap, Daniel James Macdonnell",M,34,1925,1988,63,61-70
460,"Hovdebo, Stanley J.",M,34,1925,1988,63,61-70
461,"Layton, Robert E.J.",M,34,1925,1988,63,61-70
462,"Marin, Charles-Eugène",M,34,1925,1988,63,61-70
463,"Mitchell, Margaret Anne",F,34,1925,1988,63,61-70
464,"Caccia, Charles L.",M,35,1930,1993,63,61-70
465,"Dupuy, Michel",M,35,1930,1993,63,61-70
466,"Gaffney, Beryl",F,35,1930,1993,63,61-70
467,"Harris, Richard M.",M,35,1930,1993,63,61-70
468,"Hopkins, Leonard Donald",M,35,1930,1993,63,61-70
469,"Peters, Douglas Dennison",M,35,1930,1993,63,61-70
470,"Verran, Harry",M,35,1930,1993,63,61-70
471,"Bachand, André",M,36,1934,1997,63,61-70
472,"Bachand, André",M,36,1934,1997,63,61-70
473,"Bernier, Gilles",M,36,1934,1997,63,61-70
474,"Bernier, Gilles",M,36,1934,1997,63,61-70
475,"Chrétien, Joseph Jacques Jean",M,36,1934,1997,63,61-70
476,"Augustine, Jean",F,37,1937,2000,63,61-70
477,"Mayfield, Philip William",M,37,1937,2000,63,61-70
478,"Tremblay, Suzanne",F,37,1937,2000,63,61-70
479,"Boulianne, Marc",M,38,1941,2004,63,61-70
480,"Brown, Bonnie",F,38,1941,2004,63,61-70
481,"Carrier, Robert",M,38,1941,2004,63,61-70
482,"Fry, Hedy",F,38,1941,2004,63,61-70
483,"Johnston, F. Dale",M,38,1941,2004,63,61-70
484,"Kilgour, David",M,38,1941,2004,63,61-70
485,"Ménard, Serge",M,38,1941,2004,63,61-70
486,"Mills, Robert (Bob)",M,38,1941,2004,63,61-70
487,"Peterson, James Scott (Jim)",M,38,1941,2004,63,61-70
488,"Poirier-Rivard, Denise",F,38,1941,2004,63,61-70
489,"Tilson, David",M,38,1941,2004,63,61-70
490,"Arthur, André",M,39,1943,2006,63,61-70
491,"Black, Dawn",F,39,1943,2006,63,61-70
492,"Bouchard, Robert",M,39,1943,2006,63,61-70
493,"Hanger, Art",M,39,1943,2006,63,61-70
494,"Hearn, Loyola",M,39,1943,2006,63,61-70
495,"Lessard, Yves",M,39,1943,2006,63,61-70
496,"Marleau, Diane",F,39,1943,2006,63,61-70
497,"Patry, Bernard",M,39,1943,2006,63,61-70
498,"Plamondon, Louis",M,39,1943,2006,63,61-70
499,"Savoie, Denise",F,39,1943,2006,63,61-70
500,"Schellenberger, Gary",M,39,1943,2006,63,61-70
501,"Tonks, Alan",M,39,1943,2006,63,61-70
502,"Atamanenko, Alex",M,40,1945,2008,63,61-70
503,"Breitkreuz, Garry W.",M,40,1945,2008,63,61-70
504,"Casey, William D. (Bill)",M,40,1945,2008,63,61-70
505,"Gaudet, Roger",M,40,1945,2008,63,61-70
506,"Payne, LaVar",M,40,1945,2008,63,61-70
507,"Duncan, John",M,41,1948,2011,63,61-70
508,"Eglinski, Jim",M,41,1948,2011,63,61-70
509,"Harris, Jack",M,41,1948,2011,63,61-70
510,"Mayes, Colin",M,41,1948,2011,63,61-70
511,"McKay, John",M,41,1948,2011,63,61-70
512,"Norlock, Rick",M,41,1948,2011,63,61-70
513,"Rae, Bob",M,41,1948,2011,63,61-70
514,"Wong, Alice",F,40,1948,2008,60,51-60
515,"Foote, Judy",F,42,1952,2015,63,61-70
516,"Kitchen, Robert Gordon",M,42,1952,2015,63,61-70
517,"Nicholson, Rob",M,42,1952,2015,63,61-70
518,"Rudd, Kim",F,42,1952,2015,63,61-70
519,"Saroya, Bob",M,42,1952,2015,63,61-70
520,"Stetski, Wayne",M,42,1952,2015,63,61-70
521,"Cooper, Michael",M,43,1956,2019,63,61-70
522,"Diotte, Kerry",M,43,1956,2019,63,61-70
523,"Duvall, Scott",M,43,1956,2019,63,61-70
524,"Gladu, Marilyn",F,43,1956,2019,63,61-70
525,"Longfield, Lloyd",M,43,1956,2019,63,61-70
526,"Morrison, Rob",M,43,1956,2019,63,61-70
527,"Oliphant, Robert",M,43,1956,2019,63,61-70
528,"Tassi, Filomena",F,43,1956,2019,63,61-70
529,"Wagantall, Cathay",F,42,1956,2015,59,51-60
530,"Wagantall, Cathay",F,43,1956,2019,63,61-70
531,"Forest, Yves",M,28,1921,1968,47,41-50
532,"Gilbert, John",M,28,1921,1968,47,41-50
533,"Harries, Hu",M,28,1921,1968,47,41-50
534,"Honey, Russell Clayton",M,28,1921,1968,47,41-50
535,"Jamieson, Donald Campbell",M,28,1921,1968,47,41-50
536,"LeBlanc, Louis Guy",M,28,1921,1968,47,41-50
537,"Loiselle, Gérard",M,28,1921,1968,47,41-50
538,"Mackasey, Bryce Stuart",M,28,1921,1968,47,41-50
539,"Otto, Steven",M,28,1921,1968,47,41-50
540,"Saltsman, Max",M,28,1921,1968,47,41-50
541,"Scott, William C.",M,28,1921,1968,47,41-50
542,"Smith, G.A. Percy",M,28,1921,1968,47,41-50
543,"Stafford, Harold Edwin",M,28,1921,1968,47,41-50
544,"Alexander, Lincoln MacCauley",M,28,1922,1968,46,41-50
545,"Béchard, Albert",M,28,1922,1968,46,41-50
546,"Cyr, Alexandre",M,28,1922,1968,46,41-50
547,"Gibson, Colin David",M,28,1922,1968,46,41-50
548,"Gillespie, Alastair William",M,28,1922,1968,46,41-50
549,"Crouse, Lloyd Roseville",M,32,1918,1980,62,61-70
550,"Leduc, Jean-Louis",M,32,1918,1980,62,61-70
551,"MacDonald, Daniel Joseph",M,32,1918,1980,62,61-70
552,"Orlikow, David",M,32,1918,1980,62,61-70
553,"Schroder, James Duncan",M,32,1918,1980,62,61-70
554,"Jewett, Pauline",F,33,1922,1984,62,61-70
555,"Sauvé, Jeanne",F,33,1922,1984,62,61-70
556,"Van De Walle, Walter",M,33,1922,1984,62,61-70
557,"Cook, Charles Henry (Chuck)",M,34,1926,1988,62,61-70
558,"Halliday, Bruce",M,34,1926,1988,62,61-70
559,"Dromisky, Stanley Peter (Stan)",M,35,1931,1993,62,61-70
560,"Frazer, John L. (Jack)",M,35,1931,1993,62,61-70
561,"Gray, Herbert Eser (Herb)",M,35,1931,1993,62,61-70
562,"Harper, Edward (Ed)",M,35,1931,1993,62,61-70
563,"Pagtakhan, Rey D.",M,36,1935,1997,62,61-70
564,"Parent, Gilbert",M,36,1935,1997,62,61-70
565,"Dalphond-Guiral, Madeleine",F,37,1938,2000,62,61-70
566,"Fournier, Ghislain",M,37,1938,2000,62,61-70
567,"Harvard, John",M,37,1938,2000,62,61-70
568,"Martin, Paul Edgar Philippe",M,37,1938,2000,62,61-70
569,"Phinney, Elizabeth  (Beth)",F,37,1938,2000,62,61-70
570,"Abbott, Jim",M,38,1942,2004,62,61-70
571,"Bell, Don",M,38,1942,2004,62,61-70
572,"Bonin, Raymond",M,38,1942,2004,62,61-70
573,"Cummins, John Martin",M,38,1942,2004,62,61-70
574,"Godfrey, John Ferguson",M,38,1942,2004,62,61-70
575,"Neville, Anita",F,38,1942,2004,62,61-70
576,"Penson, Charles Frederick (Charlie)",M,38,1942,2004,62,61-70
577,"Reynolds, John Douglas",M,38,1942,2004,62,61-70
578,"Savage, Michael John",M,38,1942,2004,62,61-70
579,"Steckle, Paul Daniel",M,38,1942,2004,62,61-70
580,"Beaumier, Colleen",F,39,1944,2006,62,61-70
581,"Cullen, Roy",M,39,1944,2006,62,61-70
582,"Goldring, Peter",M,39,1944,2006,62,61-70
583,"Lauzon, Guy",M,39,1944,2006,62,61-70
584,"Lussier, Marcel",M,39,1944,2006,62,61-70
585,"McDonough, Alexa",F,39,1944,2006,62,61-70
586,"McGuire, Joseph Blair (Joe)",M,39,1944,2006,62,61-70
587,"Oda, Bev",F,39,1944,2006,62,61-70
588,"Priddy, Penny",F,39,1944,2006,62,61-70
589,"Sgro, Judy",F,39,1944,2006,62,61-70
590,"Bergen, Candice",F,40,1946,2008,62,61-70
591,"Davidson, Patricia",F,40,1946,2008,62,61-70
592,"Dosanjh, Ujjal",M,40,1946,2008,62,61-70
593,"Hyer, Bruce",M,40,1946,2008,62,61-70
594,"MacAulay, Lawrence",M,40,1946,2008,62,61-70
595,"MacKenzie, Dave",M,40,1946,2008,62,61-70
596,"Milliken, Peter Andrew Stewart",M,40,1946,2008,62,61-70
597,"Proulx, Marcel",M,40,1946,2008,62,61-70
598,"Ablonczy, Diane",F,41,1949,2011,62,61-70
599,"Albrecht, Harold",M,41,1949,2011,62,61-70
600,"Aspin, Jay",M,41,1949,2011,62,61-70
601,"Chisu, Corneliu",M,41,1949,2011,62,61-70
602,"Duncan, Linda Francis",F,41,1949,2011,62,61-70
603,"Easter, Wayne",M,41,1949,2011,62,61-70
604,"Flaherty, James Michael (Jim)",M,41,1949,2011,62,61-70
605,"Garneau, Marc",M,41,1949,2011,62,61-70
606,"Goodale, Ralph",M,41,1949,2011,62,61-70
607,"Gravelle, Claude",M,41,1949,2011,62,61-70
608,"Komarnicki, Ed",M,41,1949,2011,62,61-70
609,"Maguire, Larry",M,41,1949,2011,62,61-70
610,"O'Neill Gordon, Tilly",F,41,1949,2011,62,61-70
611,"Arnold, Mel",M,42,1953,2015,62,61-70
612,"Dreeshen, Earl",M,42,1953,2015,62,61-70
613,"McCrimmon, Karen",F,42,1953,2015,62,61-70
614,"Motz, Glen",M,42,1953,2015,62,61-70
615,"Rioux, Jean R.",M,42,1953,2015,62,61-70
616,"Rogers, Churence",M,42,1953,2015,62,61-70
617,"Yelich, Lynne",F,41,1953,2011,58,51-60
618,"Arya, Chandra",M,43,1957,2019,62,61-70
619,"Finley, Diane",F,43,1957,2019,62,61-70
620,"Koutrakis, Annie",F,43,1957,2019,62,61-70
621,"McLeod, Cathy",F,43,1957,2019,62,61-70
622,"Scarpaleggia, Francis",M,43,1957,2019,62,61-70
623,"Stanton, Bruce",M,43,1957,2019,62,61-70
624,"Sweet, David",M,43,1957,2019,62,61-70
625,"Givens, Philip Gerald",M,28,1922,1968,46,41-50
626,"Howard, Bruce Andrew Thomas",M,28,1922,1968,46,41-50
627,"McCleave, Robert Jardine",M,28,1922,1968,46,41-50
628,"Peters, William Arnold",M,28,1922,1968,46,41-50
629,"Richardson, James Armstrong",M,28,1922,1968,46,41-50
630,"Rock, Raymond",M,28,1922,1968,46,41-50
631,"Skoreyko, William",M,28,1922,1968,46,41-50
632,"Valade, Georges-J.",M,28,1922,1968,46,41-50
633,"Yanakis, Antonio",M,28,1922,1968,46,41-50
634,"Bell, Thomas Miller",M,28,1923,1968,45,41-50
635,"Benson, Edgar John",M,28,1923,1968,45,41-50
636,"Dupras, Maurice",M,28,1923,1968,45,41-50
637,"Fairweather, Robert Gordon Lee",M,28,1923,1968,45,41-50
638,"Hellyer, Paul Theodore",M,28,1923,1968,45,41-50
639,"Legault, Carl",M,28,1923,1968,45,41-50
640,"Morison, John B.",M,28,1923,1968,45,41-50
641,"Roy, Jean Robert",M,28,1923,1968,45,41-50
642,"St. Pierre, Paul",M,28,1923,1968,45,41-50
643,"Tolmie, Donald Ross",M,28,1923,1968,45,41-50
644,"Beaudoin, Léonel",M,28,1924,1968,44,41-50
645,"Deakon, Walter Cyril",M,28,1924,1968,44,41-50
646,"Laniel, Gérald",M,28,1924,1968,44,41-50
647,"Nielsen, Erik",M,28,1924,1968,44,41-50
648,"Lambert, Marcel Joseph Aimé",M,32,1919,1980,61,61-70
649,"Lamontagne, J. Gilles",M,32,1919,1980,61,61-70
650,"Mitges, Constantine George (Gus)",M,32,1919,1980,61,61-70
651,"Towers, Thomas Gordon",M,32,1919,1980,61,61-70
652,"Trudeau, Pierre Elliott",M,32,1919,1980,61,61-70
653,"Bertrand, Gabrielle",F,33,1923,1984,61,61-70
654,"Dantzer, Vincent Martin",M,33,1923,1984,61,61-70
655,"King, Frederick John",M,33,1923,1984,61,61-70
656,"Lesick, William",M,33,1923,1984,61,61-70
657,"McCuish, Robert Lorne",M,33,1923,1984,61,61-70
658,"Porter, Robert Harold",M,33,1923,1984,61,61-70
659,"Chadwick, Harry",M,34,1927,1988,61,61-70
660,"Fretz, Claude Girvin (Girve)",M,34,1927,1988,61,61-70
661,"Hogue, Jean-Pierre",M,34,1927,1988,61,61-70
662,"Allmand, William Warren",M,35,1932,1993,61,61-70
663,"Bellemare, Eugène",M,35,1932,1993,61,61-70
664,"Crawford, Rex",M,35,1932,1993,61,61-70
665,"Godin, Maurice",M,35,1932,1993,61,61-70
666,"Morrison, Lee Glen",M,35,1932,1993,61,61-70
667,"Richardson, John",M,35,1932,1993,61,61-70
668,"Schmidt, Werner",M,35,1932,1993,61,61-70
669,"Wayne, Elsie Eleanore",F,35,1932,1993,61,61-70
670,"Adams, Peter",M,36,1936,1997,61,61-70
671,"Canuel, René",M,36,1936,1997,61,61-70
672,"Hoeppner, Jake E.",M,36,1936,1997,61,61-70
673,"Pillitteri, Gary Orazio Vincenzo",M,36,1936,1997,61,61-70
674,"Reed, Julian Alexander Arnott",M,36,1936,1997,61,61-70
675,"Thompson, Myron",M,36,1936,1997,61,61-70
676,"Catterall, Marlene",F,37,1939,2000,61,61-70
677,"Clark, Charles Joseph",M,37,1939,2000,61,61-70
678,"Epp, Ken",M,37,1939,2000,61,61-70
679,"Graham, Bill",M,37,1939,2000,61,61-70
680,"Jackson, Ovid L.",M,37,1939,2000,61,61-70
681,"Thibeault, Yolande",F,37,1939,2000,61,61-70
682,"Bouchard, Robert",M,38,1943,2004,61,61-70
683,"Hanger, Art",M,38,1943,2004,61,61-70
684,"Hearn, Loyola",M,38,1943,2004,61,61-70
685,"Lessard, Yves",M,38,1943,2004,61,61-70
686,"Marleau, Diane",F,38,1943,2004,61,61-70
687,"Patry, Bernard",M,38,1943,2004,61,61-70
688,"Plamondon, Louis",M,38,1943,2004,61,61-70
689,"Schellenberger, Gary",M,38,1943,2004,61,61-70
690,"Tonks, Alan",M,38,1943,2004,61,61-70
691,"Atamanenko, Alex",M,39,1945,2006,61,61-70
692,"Breitkreuz, Garry W.",M,39,1945,2006,61,61-70
693,"Casey, William D. (Bill)",M,39,1945,2006,61,61-70
694,"Emerson, David",M,39,1945,2006,61,61-70
695,"Fitzpatrick, Brian",M,39,1945,2006,61,61-70
696,"Gaudet, Roger",M,39,1945,2006,61,61-70
697,"Maloney, John",M,39,1945,2006,61,61-70
698,"Robillard, Lucienne",F,39,1945,2006,61,61-70
699,"Skelton, Carol",F,39,1945,2006,61,61-70
700,"Cannon, Lawrence",M,40,1947,2008,61,61-70
701,"Comartin, Joe",M,40,1947,2008,61,61-70
702,"Dryden, Ken",M,40,1947,2008,61,61-70
703,"Duceppe, Gilles",M,40,1947,2008,61,61-70
704,"Galipeau, Joseph Bernard Royal Neil",M,40,1947,2008,61,61-70
705,"Hawn, Laurie",M,40,1947,2008,61,61-70
706,"Ignatieff, Michael",M,40,1947,2008,61,61-70
707,"Kerr, Greg",M,40,1947,2008,61,61-70
708,"Kramp, Daryl",M,40,1947,2008,61,61-70
709,"Mark, Inky",M,40,1947,2008,61,61-70
710,"Marston, Wayne",M,40,1947,2008,61,61-70
711,"Pomerleau, Roger",M,40,1947,2008,61,61-70
712,"Richardson, Lee",M,40,1947,2008,61,61-70
713,"Shipley, Bev",M,40,1947,2008,61,61-70
714,"Smith, Joy",F,40,1947,2008,61,61-70
715,"Thompson, Gregory Francis",M,40,1947,2008,61,61-70
716,"Volpe, Giuseppe (Joseph)",M,39,1947,2006,59,51-60
717,"Bennett, Carolyn",F,41,1950,2011,61,61-70
718,"Benoit, Leon Earl",M,41,1950,2011,61,61-70
719,"Layton, Jack",M,41,1950,2011,61,61-70
720,"Leung, Chungsen",M,41,1950,2011,61,61-70
721,"McCallum, John",M,41,1950,2011,61,61-70
722,"Obhrai, Deepak",M,41,1950,2011,61,61-70
723,"Rankin, Murray",M,41,1950,2011,61,61-70
724,"Warawa, Mark",M,40,1950,2008,58,51-60
725,"Zarac, Lise",F,40,1950,2008,58,51-60
726,"Blair, Bill",M,42,1954,2015,61,61-70
727,"Bossio, Mike",M,42,1954,2015,61,61-70
728,"Cannings, Richard",M,42,1954,2015,61,61-70
729,"Christopherson, David",M,42,1954,2015,61,61-70
730,"Lebel, Denis",M,42,1954,2015,61,61-70
731,"May, Elizabeth",F,42,1954,2015,61,61-70
732,"McColeman, Phil",M,42,1954,2015,61,61-70
733,"Morrissey, Robert",M,42,1954,2015,61,61-70
734,"Mulcair, Thomas J.",M,42,1954,2015,61,61-70
735,"Murray, Joyce",F,42,1954,2015,61,61-70
736,"Schulte, Deborah",F,42,1954,2015,61,61-70
737,"Woodworth, Stephen",M,41,1954,2011,57,51-60
738,"Desilets, Luc",M,43,1958,2019,61,61-70
739,"Dubourg, Emmanuel",M,43,1958,2019,61,61-70
740,"Hughes, Carol",F,43,1958,2019,61,61-70
741,"Shanahan, Brenda",F,43,1958,2019,61,61-70
742,"Pepin, Jean-Luc",M,28,1924,1968,44,41-50
743,"Rose, Mark Willson",M,28,1924,1968,44,41-50
744,"Thomson, Roderick J. (Rod)",M,28,1924,1968,44,41-50
745,"Benjamin, Leslie Gordon",M,28,1925,1968,43,41-50
746,"Gervais, Paul Mullins",M,28,1925,1968,43,41-50
747,"Howard, Frank",M,28,1925,1968,43,41-50
748,"Laflamme, Ovide",M,28,1925,1968,43,41-50
749,"Laprise, Gérard",M,28,1925,1968,43,41-50
750,"MacEwan, Howard Russell",M,28,1925,1968,43,41-50
751,"Borrie, Robert James",M,28,1926,1968,42,41-50
752,"Corriveau, Léopold",M,28,1926,1968,42,41-50
753,"Dubé, Jean-Eudes",M,28,1926,1968,42,41-50
754,"Godin, Roland",M,28,1926,1968,42,41-50
755,"Lachance, Georges-C.",M,28,1926,1968,42,41-50
756,"Langlois, Paul",M,28,1926,1968,42,41-50
757,"Lessard, Marcel",M,28,1926,1968,42,41-50
758,"Murphy, Charles Terrence",M,28,1926,1968,42,41-50
759,"Orange, Robert John (Bud)",M,28,1926,1968,42,41-50
760,"Skoberg, John Leroy",M,28,1926,1968,42,41-50
761,"Burton, John Stratford",M,28,1927,1968,41,41-50
762,"Cobbe, Gerald Richard",M,28,1927,1968,41,41-50
763,"Francis, Cyril Lloyd",M,32,1920,1980,60,51-60
764,"Gendron, Rosaire",M,32,1920,1980,60,51-60
765,"Isabelle, Joseph Gaston",M,32,1920,1980,60,51-60
766,"McKenzie, A. Daniel",M,33,1924,1984,60,51-60
767,"Nielsen, Erik",M,33,1924,1984,60,51-60
768,"Winegard, William C.",M,33,1924,1984,60,51-60
769,"Jordan, Jim",M,34,1928,1988,60,51-60
770,"Paproski, Steve Eugene",M,34,1928,1988,60,51-60
771,"Comuzzi, Joseph R. (Joe)",M,35,1933,1993,60,51-60
772,"Flis, Jesse Philip",M,35,1933,1993,60,51-60
773,"Augustine, Jean",F,36,1937,1997,60,51-60
774,"Mayfield, Philip William",M,36,1937,1997,60,51-60
775,"Ramsay, F.J. (Jack)",M,36,1937,1997,60,51-60
776,"Tremblay, Suzanne",F,36,1937,1997,60,51-60
777,"Assad, Mark Joseph",M,37,1940,2000,60,51-60
778,"Charbonneau, Yvon",M,37,1940,2000,60,51-60
779,"Cotler, Irwin",M,37,1940,2000,60,51-60
780,"Folco, Raymonde",F,37,1940,2000,60,51-60
781,"Hubbard, Charles",M,37,1940,2000,60,51-60
782,"Lalonde, Francine",F,37,1940,2000,60,51-60
783,"Lastewka, Walt",M,37,1940,2000,60,51-60
784,"McCormick, Larry",M,37,1940,2000,60,51-60
785,"O'Reilly, John Francis",M,37,1940,2000,60,51-60
786,"Perron, Gilles-A.",M,37,1940,2000,60,51-60
787,"Pickard, Jerry",M,37,1940,2000,60,51-60
788,"St-Julien, Guy",M,37,1940,2000,60,51-60
789,"Wood, Bob",M,36,1940,1997,57,51-60
790,"Beaumier, Colleen",F,38,1944,2004,60,51-60
791,"Carroll, M. Aileen",F,38,1944,2004,60,51-60
792,"Cullen, Roy",M,38,1944,2004,60,51-60
793,"Efford, Ruben John",M,38,1944,2004,60,51-60
794,"Goldring, Peter",M,38,1944,2004,60,51-60
795,"Lapierre, Réal",M,38,1944,2004,60,51-60
796,"Lauzon, Guy",M,38,1944,2004,60,51-60
797,"Macklin, Paul Harold",M,38,1944,2004,60,51-60
798,"McDonough, Alexa",F,38,1944,2004,60,51-60
799,"McGuire, Joseph Blair (Joe)",M,38,1944,2004,60,51-60
800,"Oda, Bev",F,38,1944,2004,60,51-60
801,"Sgro, Judy",F,38,1944,2004,60,51-60
802,"Davidson, Patricia",F,39,1946,2006,60,51-60
803,"Dosanjh, Ujjal",M,39,1946,2006,60,51-60
804,"Khan, Wajid",M,39,1946,2006,60,51-60
805,"MacAulay, Lawrence",M,39,1946,2006,60,51-60
806,"MacKenzie, Dave",M,39,1946,2006,60,51-60
807,"Milliken, Peter Andrew Stewart",M,39,1946,2006,60,51-60
808,"Proulx, Marcel",M,39,1946,2006,60,51-60
809,"Telegdi, Andrew",M,39,1946,2006,60,51-60
810,"Thibault, Louise",F,39,1946,2006,60,51-60
811,"Blackburn, Jean-Pierre",M,40,1948,2008,60,51-60
812,"Casson, Rick",M,40,1948,2008,60,51-60
813,"Duncan, John",M,40,1948,2008,60,51-60
814,"Gagnon, Christiane",F,40,1948,2008,60,51-60
815,"Harris, Jack",M,40,1948,2008,60,51-60
816,"Lee, Derek Vincent",M,40,1948,2008,60,51-60
817,"Martin, Tony",M,40,1948,2008,60,51-60
818,"Mayes, Colin",M,40,1948,2008,60,51-60
819,"McKay, John",M,40,1948,2008,60,51-60
820,"Minna, Maria",F,40,1948,2008,60,51-60
821,"Norlock, Rick",M,40,1948,2008,60,51-60
822,"Petit, Daniel",M,40,1948,2008,60,51-60
823,"Rae, Bob",M,40,1948,2008,60,51-60
824,"Szabo, Paul John Mark",M,40,1948,2008,60,51-60
825,"Garrison, Randall",M,41,1951,2011,60,51-60
826,"Lukiwski, Tom",M,41,1951,2011,60,51-60
827,"Lunney, James",M,41,1951,2011,60,51-60
828,"Mathyssen, Irene",F,41,1951,2011,60,51-60
829,"Morin, Marc-André",M,41,1951,2011,60,51-60
830,"Nash, Peggy",F,41,1951,2011,60,51-60
831,"Ritz, Gerry",M,41,1951,2011,60,51-60
832,"Sopuck, Robert",M,41,1951,2011,60,51-60
833,"Wasylycia-Leis, Judy",F,40,1951,2008,57,51-60
834,"Bélanger, Mauril",M,42,1955,2015,60,51-60
835,"Boutin-Sweet, Marjolaine",F,42,1955,2015,60,51-60
836,"Cuzner, Rodger",M,42,1955,2015,60,51-60
837,"Dion, Stéphane",M,42,1955,2015,60,51-60
838,"El-Khoury, Fayçal",M,42,1955,2015,60,51-60
839,"Fast, Edward",M,42,1955,2015,60,51-60
840,"Laverdière, Hélène",F,42,1955,2015,60,51-60
841,"Mihychuk, MaryAnn",F,42,1955,2015,60,51-60
842,"Nault, Robert Daniel",M,42,1955,2015,60,51-60
843,"Van Kesteren, Dave",M,42,1955,2015,60,51-60
844,"Vellacott, Maurice",M,41,1955,2011,56,51-60
845,"Beaulieu, Mario",M,43,1959,2019,60,51-60
846,"Beaulieu, Mario",M,43,1959,2019,60,51-60
847,"Benzen, Bob",M,43,1959,2019,60,51-60
848,"Hutchings, Gudie",F,43,1959,2019,60,51-60
849,"Lebouthillier, Diane",F,43,1959,2019,60,51-60
850,"McDonald, Ken",M,43,1959,2019,60,51-60
851,"McLeod, Michael",M,43,1959,2019,60,51-60
852,"Regan, Geoff",M,43,1959,2019,60,51-60
853,"Samson, Darrell",M,43,1959,2019,60,51-60
854,"Watts, Dianne L.",F,42,1959,2015,56,51-60
855,"Zann, Lenore",F,43,1959,2019,60,51-60
856,"Cullen, Jack Sydney George (Bud)",M,28,1927,1968,41,41-50
857,"Dumont, Bernard",M,28,1927,1968,41,41-50
858,"Hogarth, Douglas Aird",M,28,1927,1968,41,41-50
859,"Horner, John (Jack) Henry",M,28,1927,1968,41,41-50
860,"Peddle, Ambrose Hubert",M,28,1927,1968,41,41-50
861,"Robinson, William Kenneth",M,28,1927,1968,41,41-50
862,"Cafik, Norman Augustine",M,28,1928,1968,40,31-40
863,"Coates, Robert Carman",M,28,1928,1968,40,31-40
864,"Downey, Cliff",M,28,1928,1968,40,31-40
865,"La Salle, Roch",M,28,1928,1968,40,31-40
866,"Lajoie, Claude G.",M,28,1928,1968,40,31-40
867,"Marceau, Gilles",M,28,1928,1968,40,31-40
868,"McKinley, Robert Elgin",M,28,1928,1968,40,31-40
869,"Paproski, Steve Eugene",M,28,1928,1968,40,31-40
870,"Portelance, Arthur",M,28,1928,1968,40,31-40
871,"Hamilton, Frank Fletcher",M,32,1921,1980,59,51-60
872,"Huntington, Arthur Ronald",M,32,1921,1980,59,51-60
873,"Kempling, William James",M,32,1921,1980,59,51-60
874,"Mackasey, Bryce Stuart",M,32,1921,1980,59,51-60
875,"Scott, William C.",M,32,1921,1980,59,51-60
876,"Benjamin, Leslie Gordon",M,33,1925,1984,59,51-60
877,"Heap, Daniel James Macdonnell",M,33,1925,1984,59,51-60
878,"Hovdebo, Stanley J.",M,33,1925,1984,59,51-60
879,"Ladouceur, Fernand",M,33,1925,1984,59,51-60
880,"Lawrence, Allan Frederick",M,33,1925,1984,59,51-60
881,"Layton, Robert E.J.",M,33,1925,1984,59,51-60
882,"Marin, Charles-Eugène",M,33,1925,1984,59,51-60
883,"Mitchell, Margaret Anne",F,33,1925,1984,59,51-60
884,"Pietz, Allan Ernest",M,33,1925,1984,59,51-60
885,"Rossi, Carlo",M,33,1925,1984,59,51-60
886,"Scowen, Jack",M,33,1925,1984,59,51-60
887,"Stackhouse, Reginald Francis",M,33,1925,1984,59,51-60
888,"Ferguson, Ralph",M,34,1929,1988,59,51-60
889,"Friesen, Benno",M,34,1929,1988,59,51-60
890,"Loiselle, Gilles",M,34,1929,1988,59,51-60
891,"Shields, Jack Wendele",M,34,1929,1988,59,51-60
892,"Tétreault, Jacques",M,34,1929,1988,59,51-60
893,"Turner, John Napier",M,34,1929,1988,59,51-60
894,"Bernier, Gilles",M,35,1934,1993,59,51-60
895,"Bernier, Gilles",M,35,1934,1993,59,51-60
896,"Chrétien, Joseph Jacques Jean",M,35,1934,1993,59,51-60
897,"Grubel, Herbert G. ( Herb)",M,35,1934,1993,59,51-60
898,"Hnatyshyn, Ramon John",M,35,1934,1993,59,51-60
899,"MacLaren, Roy",M,35,1934,1993,59,51-60
900,"Worthy, Dave",M,34,1934,1988,54,51-60
901,"Dalphond-Guiral, Madeleine",F,36,1938,1997,59,51-60
902,"Debien, Maud",F,36,1938,1997,59,51-60
903,"Fournier, Ghislain",M,36,1938,1997,59,51-60
904,"Harvard, John",M,36,1938,1997,59,51-60
905,"Martin, Paul Edgar Philippe",M,36,1938,1997,59,51-60
906,"Mifflin, Fred J.",M,36,1938,1997,59,51-60
907,"Phinney, Elizabeth  (Beth)",F,36,1938,1997,59,51-60
908,"Barrette, Gilbert",M,37,1941,2000,59,51-60
909,"Brown, Bonnie",F,37,1941,2000,59,51-60
910,"Carignan, Jean Guy",M,37,1941,2000,59,51-60
911,"Fry, Hedy",F,37,1941,2000,59,51-60
912,"Harvey, André",M,37,1941,2000,59,51-60
913,"Johnston, F. Dale",M,37,1941,2000,59,51-60
914,"Kilgour, David",M,37,1941,2000,59,51-60
915,"Mills, Robert (Bob)",M,37,1941,2000,59,51-60
916,"Peterson, James Scott (Jim)",M,37,1941,2000,59,51-60
917,"Proctor, Dick",M,37,1941,2000,59,51-60
918,"Spencer, Larry",M,37,1941,2000,59,51-60
919,"Breitkreuz, Garry W.",M,38,1945,2004,59,51-60
920,"Casey, William D. (Bill)",M,38,1945,2004,59,51-60
921,"Emerson, David",M,38,1945,2004,59,51-60
922,"Fitzpatrick, Brian",M,38,1945,2004,59,51-60
923,"Gaudet, Roger",M,38,1945,2004,59,51-60
924,"Maloney, John",M,38,1945,2004,59,51-60
925,"Robillard, Lucienne",F,38,1945,2004,59,51-60
926,"Skelton, Carol",F,38,1945,2004,59,51-60
927,"Stinson, Darrel",M,38,1945,2004,59,51-60
928,"Venne, Pierrette",F,37,1945,2000,55,51-60
929,"Cannon, Lawrence",M,39,1947,2006,59,51-60
930,"Comartin, Joe",M,39,1947,2006,59,51-60
931,"Dryden, Ken",M,39,1947,2006,59,51-60
932,"Duceppe, Gilles",M,39,1947,2006,59,51-60
933,"Galipeau, Joseph Bernard Royal Neil",M,39,1947,2006,59,51-60
934,"Hawn, Laurie",M,39,1947,2006,59,51-60
935,"Ignatieff, Michael",M,39,1947,2006,59,51-60
936,"Kramp, Daryl",M,39,1947,2006,59,51-60
937,"Mark, Inky",M,39,1947,2006,59,51-60
938,"Marston, Wayne",M,39,1947,2006,59,51-60
939,"Matthews, Bill",M,39,1947,2006,59,51-60
940,"Picard, Pauline",F,39,1947,2006,59,51-60
941,"Richardson, Lee",M,39,1947,2006,59,51-60
942,"Shipley, Bev",M,39,1947,2006,59,51-60
943,"Smith, Joy",F,39,1947,2006,59,51-60
944,"Thompson, Gregory Francis",M,39,1947,2006,59,51-60
945,"Volpe, Giuseppe (Joseph)",M,38,1947,2004,57,51-60
946,"Ablonczy, Diane",F,40,1949,2008,59,51-60
947,"Albrecht, Harold",M,40,1949,2008,59,51-60
948,"Bagnell, Larry",M,40,1949,2008,59,51-60
949,"Bourgeois, Diane",F,40,1949,2008,59,51-60
950,"Duncan, Linda Francis",F,40,1949,2008,59,51-60
951,"Easter, Wayne",M,40,1949,2008,59,51-60
952,"Flaherty, James Michael (Jim)",M,40,1949,2008,59,51-60
953,"Freeman, Carole",F,40,1949,2008,59,51-60
954,"Garneau, Marc",M,40,1949,2008,59,51-60
955,"Goodale, Ralph",M,40,1949,2008,59,51-60
956,"Gravelle, Claude",M,40,1949,2008,59,51-60
957,"Komarnicki, Ed",M,40,1949,2008,59,51-60
958,"Laforest, Jean-Yves",M,40,1949,2008,59,51-60
959,"Malhi, Gurbax Singh",M,40,1949,2008,59,51-60
960,"O'Neill Gordon, Tilly",F,40,1949,2008,59,51-60
961,"Roy, Jean-Yves",M,40,1949,2008,59,51-60
962,"Ashfield, Keith",M,41,1952,2011,59,51-60
963,"Carmichael, John",M,41,1952,2011,59,51-60
964,"Crowder, Jean",F,41,1952,2011,59,51-60
965,"Foote, Judy",F,41,1952,2011,59,51-60
966,"Menzies, Ted",M,41,1952,2011,59,51-60
967,"Nicholson, Rob",M,41,1952,2011,59,51-60
968,"Sims, Jinny Jogindera",F,41,1952,2011,59,51-60
969,"Sullivan, Mike",M,41,1952,2011,59,51-60
970,"Toews, Vic",M,41,1952,2011,59,51-60
971,"Valcourt, Bernard",M,41,1952,2011,59,51-60
972,"Wilfert, Bryon",M,40,1952,2008,56,51-60
973,"Young, Terence H.",M,40,1952,2008,56,51-60
974,"Cooper, Michael",M,42,1956,2015,59,51-60
975,"Diotte, Kerry",M,42,1956,2015,59,51-60
976,"Duvall, Scott",M,42,1956,2015,59,51-60
977,"Gladu, Marilyn",F,42,1956,2015,59,51-60
978,"Longfield, Lloyd",M,42,1956,2015,59,51-60
979,"Miller, Larry",M,42,1956,2015,59,51-60
980,"Oliphant, Robert",M,42,1956,2015,59,51-60
981,"Tassi, Filomena",F,42,1956,2015,59,51-60
982,"Berthold, Luc",M,43,1960,2019,59,51-60
983,"Dalton, Marc",M,43,1960,2019,59,51-60
984,"Dhaliwal, Sukh",M,43,1960,2019,59,51-60
985,"Falk, Ted",M,43,1960,2019,59,51-60
986,"Gallant, Cheryl",F,43,1960,2019,59,51-60
987,"Jowhari, Majid",M,43,1960,2019,59,51-60
988,"McGuinty, David",M,43,1960,2019,59,51-60
989,"Powlowski, Marcus",M,43,1960,2019,59,51-60
990,"Serré, Marc G.",M,43,1960,2019,59,51-60
991,"Thériault, Luc",M,43,1960,2019,59,51-60
992,"Vandal, Daniel",M,43,1960,2019,59,51-60
993,"Webber, Len",M,42,1960,2015,55,51-60
994,"Webber, Len",M,43,1960,2019,59,51-60
995,"Wrzesnewskyj, Borys",M,42,1960,2015,55,51-60
996,"Rondeau, Gilbert F.",M,28,1928,1968,40,31-40
997,"Stewart, Donald Craig",M,28,1928,1968,40,31-40
998,"Weatherhead, David Bennington",M,28,1928,1968,40,31-40
999,"Buchanan, J. Judd",M,28,1929,1968,39,31-40
1000,"Carter, Walter C.",M,28,1929,1968,39,31-40
1001,"Comtois, Joseph-Roland",M,28,1929,1968,39,31-40
1002,"Côté, Florian",M,28,1929,1968,39,31-40
1003,"Korchinski, Stanley James",M,28,1929,1968,39,31-40
1004,"Mahoney, Patrick Morgan",M,28,1929,1968,39,31-40
1005,"Rodrigue, Romuald",M,28,1929,1968,39,31-40
1006,"Stanbury, Robert Douglas George",M,28,1929,1968,39,31-40
1007,"Stewart, Ralph Wesley",M,28,1929,1968,39,31-40
1008,"Turner, John Napier",M,28,1929,1968,39,31-40
1009,"Caccia, Charles L.",M,28,1930,1968,38,31-40
1010,"Durante, Richard John Joseph",M,28,1930,1968,38,31-40
1011,"Hopkins, Leonard Donald",M,28,1930,1968,38,31-40
1012,"Whiting, Rutherford (Rud) Lester",M,28,1930,1968,38,31-40
1013,"Gray, Herbert Eser (Herb)",M,28,1931,1968,37,31-40
1014,"MacGuigan, Mark R.",M,28,1931,1968,37,31-40
1015,"Munro, John Carr",M,28,1931,1968,37,31-40
1016,"Nowlan, John Patrick (Pat)",M,28,1931,1968,37,31-40
1017,"Allmand, William Warren",M,28,1932,1968,36,31-40
1018,"Basford, Stanley Ronald",M,28,1932,1968,36,31-40
1019,"Goyer, Jean-Pierre",M,28,1932,1968,36,31-40
1020,"Lang, Otto Emil",M,28,1932,1968,36,31-40
1021,"Macdonald, Donald Stovel",M,28,1932,1968,36,31-40
1022,"McGrath, James Aloysius",M,28,1932,1968,36,31-40
1023,"Brown, James Elisha",M,28,1933,1968,35,31-40
1024,"Faulkner, James Hugh",M,28,1933,1968,35,31-40
1025,"Alexander, Lincoln MacCauley",M,32,1922,1980,58,51-60
1026,"Cyr, Alexandre",M,32,1922,1980,58,51-60
1027,"Herbert, Harold Thomas",M,32,1922,1980,58,51-60
1028,"Jewett, Pauline",F,32,1922,1980,58,51-60
1029,"Sauvé, Jeanne",F,32,1922,1980,58,51-60
1030,"Yanakis, Antonio",M,32,1922,1980,58,51-60
1031,"Cook, Charles Henry (Chuck)",M,33,1926,1984,58,51-60
1032,"Graham, Stan",M,33,1926,1984,58,51-60
1033,"Halliday, Bruce",M,33,1926,1984,58,51-60
1034,"Yurko, William J.",M,32,1926,1980,54,51-60
1035,"Barrett, David",M,34,1930,1988,58,51-60
1036,"Blenkarn, Donald Alex",M,34,1930,1988,58,51-60
1037,"Caccia, Charles L.",M,34,1930,1988,58,51-60
1038,"Domm, William Henry (Bill)",M,34,1930,1988,58,51-60
1039,"Gaffney, Beryl",F,34,1930,1988,58,51-60
1040,"Hopkins, Leonard Donald",M,34,1930,1988,58,51-60
1041,"Kindy, Alex",M,34,1930,1988,58,51-60
1042,"Koury, Allan",M,34,1930,1988,58,51-60
1043,"Parker, Sidney James",M,34,1930,1988,58,51-60
1044,"Collins, A.B. (Bernie)",M,35,1935,1993,58,51-60
1045,"Lavigne, Laurent",M,35,1935,1993,58,51-60
1046,"Pagtakhan, Rey D.",M,35,1935,1993,58,51-60
1047,"Paré, Philippe",M,35,1935,1993,58,51-60
1048,"Parent, Gilbert",M,35,1935,1993,58,51-60
1049,"Speaker, Raymond Albert (Ray)",M,35,1935,1993,58,51-60
1050,"Axworthy, Lloyd",M,36,1939,1997,58,51-60
1051,"Catterall, Marlene",F,36,1939,1997,58,51-60
1052,"Clark, Charles Joseph",M,36,1939,1997,58,51-60
1053,"Epp, Ken",M,36,1939,1997,58,51-60
1054,"Graham, Bill",M,36,1939,1997,58,51-60
1055,"Jackson, Ovid L.",M,36,1939,1997,58,51-60
1056,"Proud, George Albert",M,36,1939,1997,58,51-60
1057,"Thibeault, Yolande",F,36,1939,1997,58,51-60
1058,"Abbott, Jim",M,37,1942,2000,58,51-60
1059,"Bonin, Raymond",M,37,1942,2000,58,51-60
1060,"Burton, Andy",M,37,1942,2000,58,51-60
1061,"Cummins, John Martin",M,37,1942,2000,58,51-60
1062,"Gagliano, Alfonso",M,37,1942,2000,58,51-60
1063,"Godfrey, John Ferguson",M,37,1942,2000,58,51-60
1064,"Manning, Ernest Preston",M,37,1942,2000,58,51-60
1065,"Neville, Anita",F,37,1942,2000,58,51-60
1066,"Penson, Charles Frederick (Charlie)",M,37,1942,2000,58,51-60
1067,"Provenzano, Carmen",M,37,1942,2000,58,51-60
1068,"Reynolds, John Douglas",M,37,1942,2000,58,51-60
1069,"Steckle, Paul Daniel",M,37,1942,2000,58,51-60
1070,"Chatters, David Cameron",M,38,1946,2004,58,51-60
1071,"DeVillers, Paul",M,38,1946,2004,58,51-60
1072,"Dosanjh, Ujjal",M,38,1946,2004,58,51-60
1073,"Forseth, Paul Eugene",M,38,1946,2004,58,51-60
1074,"Gouk, James William (Jim)",M,38,1946,2004,58,51-60
1075,"Khan, Wajid",M,38,1946,2004,58,51-60
1076,"MacAulay, Lawrence",M,38,1946,2004,58,51-60
1077,"MacKenzie, Dave",M,38,1946,2004,58,51-60
1078,"Milliken, Peter Andrew Stewart",M,38,1946,2004,58,51-60
1079,"Parrish, Carolyn",F,38,1946,2004,58,51-60
1080,"Proulx, Marcel",M,38,1946,2004,58,51-60
1081,"Telegdi, Andrew",M,38,1946,2004,58,51-60
1082,"Thibault, Louise",F,38,1946,2004,58,51-60
1083,"Ur, Rose-Marie Margaret",F,38,1946,2004,58,51-60
1084,"Blackburn, Jean-Pierre",M,39,1948,2006,58,51-60
1085,"Casson, Rick",M,39,1948,2006,58,51-60
1086,"Gagnon, Christiane",F,39,1948,2006,58,51-60
1087,"Lee, Derek Vincent",M,39,1948,2006,58,51-60
1088,"Martin, Tony",M,39,1948,2006,58,51-60
1089,"Mayes, Colin",M,39,1948,2006,58,51-60
1090,"McKay, John",M,39,1948,2006,58,51-60
1091,"Minna, Maria",F,39,1948,2006,58,51-60
1092,"Norlock, Rick",M,39,1948,2006,58,51-60
1093,"Owen, Stephen",M,39,1948,2006,58,51-60
1094,"Petit, Daniel",M,39,1948,2006,58,51-60
1095,"Rae, Bob",M,39,1948,2006,58,51-60
1096,"Szabo, Paul John Mark",M,39,1948,2006,58,51-60
1097,"White, Randy A.",M,38,1948,2004,56,51-60
1098,"Asselin, Gérard",M,40,1950,2008,58,51-60
1099,"Bennett, Carolyn",F,40,1950,2008,58,51-60
1100,"Benoit, Leon Earl",M,40,1950,2008,58,51-60
1101,"Cadman, Dona",F,40,1950,2008,58,51-60
1102,"Cardin, Serge",M,40,1950,2008,58,51-60
1103,"Day, Stockwell Burt",M,40,1950,2008,58,51-60
1104,"Demers, Nicole",F,40,1950,2008,58,51-60
1105,"Desnoyers, Luc",M,40,1950,2008,58,51-60
1106,"Layton, Jack",M,40,1950,2008,58,51-60
1107,"McCallum, John",M,40,1950,2008,58,51-60
1108,"Obhrai, Deepak",M,40,1950,2008,58,51-60
1109,"Paillé, Daniel",M,40,1950,2008,58,51-60
1110,"Pearson, Glen",M,40,1950,2008,58,51-60
1111,"Wappel, Thomas (Tom) William",M,39,1950,2006,56,51-60
1112,"Warawa, Mark",M,39,1950,2006,56,51-60
1113,"Allen, Malcolm",M,41,1953,2011,58,51-60
1114,"Bevington, Dennis Fraser",M,41,1953,2011,58,51-60
1115,"Davies, Libby",F,41,1953,2011,58,51-60
1116,"Dreeshen, Earl",M,41,1953,2011,58,51-60
1117,"Jacob, Pierre",M,41,1953,2011,58,51-60
1118,"Kamp, Randy",M,41,1953,2011,58,51-60
1119,"Keddy, Gerald",M,41,1953,2011,58,51-60
1120,"Merrifield, Rob",M,41,1953,2011,58,51-60
1121,"Patry, Claude",M,41,1953,2011,58,51-60
1122,"Perkins, Patricia (Pat)",F,41,1953,2011,58,51-60
1123,"Rafferty, John",M,41,1953,2011,58,51-60
1124,"Yelich, Lynne",F,40,1953,2008,55,51-60
1125,"Anderson, David",M,42,1957,2015,58,51-60
1126,"Anderson, David",M,42,1957,2015,58,51-60
1127,"Arya, Chandra",M,42,1957,2015,58,51-60
1128,"Benson, Sheri",F,42,1957,2015,58,51-60
1129,"Eyolfson, Doug",M,42,1957,2015,58,51-60
1130,"Finley, Diane",F,42,1957,2015,58,51-60
1131,"McLeod, Cathy",F,42,1957,2015,58,51-60
1132,"Sansoucy, Brigitte",F,42,1957,2015,58,51-60
1133,"Scarpaleggia, Francis",M,42,1957,2015,58,51-60
1134,"Stanton, Bruce",M,42,1957,2015,58,51-60
1135,"Sweet, David",M,42,1957,2015,58,51-60
1136,"Tan, Geng",M,42,1957,2015,58,51-60
1137,"Baldinelli, Tony",M,43,1961,2019,58,51-60
1138,"Block, Kelly",F,43,1961,2019,58,51-60
1139,"Cumming, James",M,43,1961,2019,58,51-60
1140,"Kwan, Jenny Wai Ching",F,43,1961,2019,58,51-60
1141,"Martel, Richard",M,43,1961,2019,58,51-60
1142,"Rota, Anthony",M,43,1961,2019,58,51-60
1143,"Vaughan, Adam",M,43,1961,2019,58,51-60
1144,"Foster, Maurice Brydon",M,28,1933,1968,35,31-40
1145,"Stewart, Ronald Alexander",M,33,1927,1984,57,51-60
1146,"Goode, Thomas Henry",M,28,1933,1968,35,31-40
1147,"Guay, Raynald Joseph Albert",M,28,1933,1968,35,31-40
1148,"Jerome, James Alexander",M,28,1933,1968,35,31-40
1149,"Moores, Frank Duff",M,28,1933,1968,35,31-40
1150,"Penner, B. Keith",M,28,1933,1968,35,31-40
1151,"Roberts, John (Moody)",M,28,1933,1968,35,31-40
1152,"Schumacher, Stanley Stanford",M,28,1933,1968,35,31-40
1153,"Blackburn, Derek Nigel Ernest",M,28,1934,1968,34,31-40
1154,"Chrétien, Joseph Jacques Jean",M,28,1934,1968,34,31-40
1155,"Watson, Ian",M,28,1934,1968,34,31-40
1156,"Matte, René",M,28,1935,1968,33,31-40
1157,"Mazankowski, Donald Frank",M,28,1935,1968,33,31-40
1158,"McBride, Murray Arndell",M,28,1935,1968,33,31-40
1159,"Schreyer, Edward Richard",M,28,1935,1968,33,31-40
1160,"Broadbent, John Edward",M,28,1936,1968,32,31-40
1161,"Guilbault, Jacques",M,28,1936,1968,32,31-40
1162,"Kaplan, Robert Phillip",M,28,1936,1968,32,31-40
1163,"MacDonald, David Samuel Horne",M,28,1936,1968,32,31-40
1164,"MacKay, Elmer MacIntosh",M,28,1936,1968,32,31-40
1165,"Roy, Marcel-Claude",M,28,1936,1968,32,31-40
1166,"Reid, John Mercer",M,28,1937,1968,31,31-40
1167,"Yewchuk, Paul",M,28,1937,1968,31,31-40
1168,"Serré, Gaetan-Joseph",M,28,1938,1968,30,18-30
1169,"Stewart, William Douglas",M,28,1938,1968,30,18-30
1170,"Bockstael, Robert Theodore",M,32,1923,1980,57,51-60
1171,"Dantzer, Vincent Martin",M,32,1923,1980,57,51-60
1172,"Desmarais, Louis R.",M,32,1923,1980,57,51-60
1173,"Dupras, Maurice",M,32,1923,1980,57,51-60
1174,"King, Frederick John",M,32,1923,1980,57,51-60
1175,"Kushner, John",M,32,1923,1980,57,51-60
1176,"McCuish, Robert Lorne",M,32,1923,1980,57,51-60
1177,"de Corneille, Roland",M,33,1927,1984,57,51-60
1178,"Fretz, Claude Girvin (Girve)",M,33,1927,1984,57,51-60
1179,"Killens, Marie Thérèse Rollande",F,33,1927,1984,57,51-60
1180,"Nicholson, Aideen",F,33,1927,1984,57,51-60
1181,"Stevens, Sinclair McKnight",M,33,1927,1984,57,51-60
1182,"Crosbie, John Carnell",M,34,1931,1988,57,51-60
1183,"Fraser, John Allen",M,34,1931,1988,57,51-60
1184,"Gray, Herbert Eser (Herb)",M,34,1931,1988,57,51-60
1185,"Guilbault, Jean-Guy",M,34,1931,1988,57,51-60
1186,"Merrithew, Gerald Stairs",M,34,1931,1988,57,51-60
1187,"Nowlan, John Patrick (Pat)",M,34,1931,1988,57,51-60
1188,"Adams, Peter",M,35,1936,1993,57,51-60
1189,"Canuel, René",M,35,1936,1993,57,51-60
1190,"Hoeppner, Jake E.",M,35,1936,1993,57,51-60
1191,"Irwin, Ron",M,35,1936,1993,57,51-60
1192,"McLaughlin, Audrey Marlene",F,35,1936,1993,57,51-60
1193,"Pillitteri, Gary Orazio Vincenzo",M,35,1936,1993,57,51-60
1194,"Reed, Julian Alexander Arnott",M,35,1936,1993,57,51-60
1195,"Thalheimer, Peter",M,35,1936,1993,57,51-60
1196,"Thompson, Myron",M,35,1936,1993,57,51-60
1197,"Assad, Mark Joseph",M,36,1940,1997,57,51-60
1198,"Breitkreuz, Cliff N.",M,36,1940,1997,57,51-60
1199,"Charbonneau, Yvon",M,36,1940,1997,57,51-60
1200,"Cotler, Irwin",M,36,1940,1997,57,51-60
1201,"Folco, Raymonde",F,36,1940,1997,57,51-60
1202,"Hubbard, Charles",M,36,1940,1997,57,51-60
1203,"Lalonde, Francine",F,36,1940,1997,57,51-60
1204,"Lastewka, Walt",M,36,1940,1997,57,51-60
1205,"Laurin, René",M,36,1940,1997,57,51-60
1206,"Massé, Marcel",M,36,1940,1997,57,51-60
1207,"McCormick, Larry",M,36,1940,1997,57,51-60
1208,"O'Reilly, John Francis",M,36,1940,1997,57,51-60
1209,"Perron, Gilles-A.",M,36,1940,1997,57,51-60
1210,"Pickard, Jerry",M,36,1940,1997,57,51-60
1211,"St-Julien, Guy",M,36,1940,1997,57,51-60
1212,"Wood, Bob",M,35,1940,1993,53,51-60
1213,"Young, M. Douglas",M,35,1940,1993,53,51-60
1214,"Bryden, John H.",M,37,1943,2000,57,51-60
1215,"Girard-Bujold, Jocelyne",F,37,1943,2000,57,51-60
1216,"Hanger, Art",M,37,1943,2000,57,51-60
1217,"Hearn, Loyola",M,37,1943,2000,57,51-60
1218,"Marleau, Diane",F,37,1943,2000,57,51-60
1219,"Normand, Gilbert",M,37,1943,2000,57,51-60
1220,"Patry, Bernard",M,37,1943,2000,57,51-60
1221,"Plamondon, Louis",M,37,1943,2000,57,51-60
1222,"Schellenberger, Gary",M,37,1943,2000,57,51-60
1223,"Tonks, Alan",M,37,1943,2000,57,51-60
1224,"Vanclief, Lyle",M,37,1943,2000,57,51-60
1225,"Comartin, Joe",M,38,1947,2004,57,51-60
1226,"Dryden, Ken",M,38,1947,2004,57,51-60
1227,"Duceppe, Gilles",M,38,1947,2004,57,51-60
1228,"Kramp, Daryl",M,38,1947,2004,57,51-60
1229,"Longfield, Judi",F,38,1947,2004,57,51-60
1230,"Mark, Inky",M,38,1947,2004,57,51-60
1231,"Matthews, Bill",M,38,1947,2004,57,51-60
1232,"Picard, Pauline",F,38,1947,2004,57,51-60
1233,"Richardson, Lee",M,38,1947,2004,57,51-60
1234,"Saada, Jacques",M,38,1947,2004,57,51-60
1235,"Smith, Joy",F,38,1947,2004,57,51-60
1236,"Thompson, Gregory Francis",M,38,1947,2004,57,51-60
1237,"Volpe, Giuseppe (Joseph)",M,37,1947,2000,53,51-60
1238,"Ablonczy, Diane",F,39,1949,2006,57,51-60
1239,"Albrecht, Harold",M,39,1949,2006,57,51-60
1240,"Bagnell, Larry",M,39,1949,2006,57,51-60
1241,"Boshcoff, Ken",M,39,1949,2006,57,51-60
1242,"Bourgeois, Diane",F,39,1949,2006,57,51-60
1243,"Easter, Wayne",M,39,1949,2006,57,51-60
1244,"Flaherty, James Michael (Jim)",M,39,1949,2006,57,51-60
1245,"Freeman, Carole",F,39,1949,2006,57,51-60
1246,"Goodale, Ralph",M,39,1949,2006,57,51-60
1247,"Komarnicki, Ed",M,39,1949,2006,57,51-60
1248,"Laforest, Jean-Yves",M,39,1949,2006,57,51-60
1249,"Malhi, Gurbax Singh",M,39,1949,2006,57,51-60
1250,"Roy, Jean-Yves",M,39,1949,2006,57,51-60
1251,"Turner, Garth",M,39,1949,2006,57,51-60
1252,"Bachand, Claude",M,40,1951,2008,57,51-60
1253,"Cannis, John",M,40,1951,2008,57,51-60
1254,"Jennings, Marlene",F,40,1951,2008,57,51-60
1255,"Lemay, Marc",M,40,1951,2008,57,51-60
1256,"Lukiwski, Tom",M,40,1951,2008,57,51-60
1257,"Lunney, James",M,40,1951,2008,57,51-60
1258,"Mathyssen, Irene",F,40,1951,2008,57,51-60
1259,"Murphy, Shawn",M,40,1951,2008,57,51-60
1260,"Ratansi, Yasmin",F,40,1951,2008,57,51-60
1261,"Ritz, Gerry",M,40,1951,2008,57,51-60
1262,"Sopuck, Robert",M,40,1951,2008,57,51-60
1263,"Wasylycia-Leis, Judy",F,39,1951,2006,55,51-60
1264,"Christopherson, David",M,41,1954,2011,57,51-60
1265,"Daniel, Joe",M,41,1954,2011,57,51-60
1266,"Day, Anne-Marie",F,41,1954,2011,57,51-60
1267,"Holder, Ed",M,41,1954,2011,57,51-60
1268,"Lebel, Denis",M,41,1954,2011,57,51-60
1269,"Lizon, Wladyslaw",M,41,1954,2011,57,51-60
1270,"May, Elizabeth",F,41,1954,2011,57,51-60
1271,"McColeman, Phil",M,41,1954,2011,57,51-60
1272,"Mulcair, Thomas J.",M,41,1954,2011,57,51-60
1273,"Murray, Joyce",F,41,1954,2011,57,51-60
1274,"Valeriote, Frank",M,41,1954,2011,57,51-60
1275,"Woodworth, Stephen",M,40,1954,2008,54,51-60
1276,"Di Iorio, Nicola",M,42,1958,2015,57,51-60
1277,"Dubourg, Emmanuel",M,42,1958,2015,57,51-60
1278,"Hughes, Carol",F,42,1958,2015,57,51-60
1279,"Shanahan, Brenda",F,42,1958,2015,57,51-60
1280,"Sorenson, Kevin",M,42,1958,2015,57,51-60
1281,"Weston, John",M,41,1958,2011,53,51-60
1282,"Angus, Charlie",M,43,1962,2019,57,51-60
1283,"Carrie, Colin",M,43,1962,2019,57,51-60
1284,"Ellis, Neil R.",M,43,1962,2019,57,51-60
1285,"Epp, Dave",M,43,1962,2019,57,51-60
1286,"Généreux, Bernard",M,43,1962,2019,57,51-60
1287,"Julian, Peter",M,43,1962,2019,57,51-60
1288,"Lametti, David",M,43,1962,2019,57,51-60
1289,"Lamoureux, Kevin",M,43,1962,2019,57,51-60
1290,"Mazier, Dan",M,43,1962,2019,57,51-60
1291,"McLean, Greg",M,43,1962,2019,57,51-60
1292,"Morantz, Marty",M,43,1962,2019,57,51-60
1293,"Morneau, Bill",M,43,1962,2019,57,51-60
1294,"Brisco, Robert Hylton",M,33,1928,1984,56,51-60
1295,"Sulatycky, Allen B.",M,28,1938,1968,30,18-30
1296,"Lundrigan, John Howard",M,28,1939,1968,29,18-30
1297,"Ouellet, André",M,28,1939,1968,29,18-30
1298,"Rowland, Douglas Charles",M,28,1940,1968,28,18-30
1299,"Comeau, Louis-Roland",M,28,1941,1968,27,18-30
1300,"Fortin, André-Gilles",M,28,1943,1968,25,18-30
1301,"Murta, Jack Burnett",M,28,1943,1968,25,18-30
1302,"Breau, Herb",M,28,1944,1968,24,18-30
1303,"Nystrom, Lorne Edmund",M,28,1946,1968,22,18-30
1304,"Knight, William George",M,28,1947,1968,21,18-30
1305,"Diefenbaker, John George",M,29,1895,1972,77,71+
1306,"Rynard, Philip Bernard",M,29,1897,1972,75,71+
1307,"Michener, Daniel Roland",M,29,1900,1972,72,71+
1308,"Douglas, Thomas Clement (Tommy)",M,29,1904,1972,68,61-70
1309,"MacDonald, Flora Isabel",F,29,1904,1972,68,61-70
1310,"MacInnis, Winona Grace",F,29,1905,1972,67,61-70
1311,"Railton, Samuel Victor",M,29,1906,1972,66,61-70
1312,"Baldwin, Gerald William",M,29,1907,1972,65,61-70
1313,"Brewin, Francis Andrew",M,29,1907,1972,65,61-70
1314,"Dionne, Charles-Eugène",M,29,1908,1972,64,61-70
1315,"Knowles, Stanley Howard",M,29,1908,1972,64,61-70
1316,"Knowles, William David",M,29,1908,1972,64,61-70
1317,"Tétrault, Oza",M,29,1908,1972,64,61-70
1318,"Barnett, Thomas Speakman",M,29,1909,1972,63,61-70
1319,"Duquet, Gérard",M,29,1909,1972,63,61-70
1320,"Hales, Alfred Dryden",M,29,1909,1972,63,61-70
1321,"Lewis, David",M,29,1909,1972,63,61-70
1322,"Mather, Barry",M,29,1909,1972,63,61-70
1323,"Hees, George Harris",M,29,1910,1972,62,61-70
1324,"Darling, Stan",M,29,1911,1972,61,61-70
1325,"Gleave, Alfred Pullen",M,29,1911,1972,61,61-70
1326,"Patterson, Alexander Bell",M,29,1911,1972,61,61-70
1327,"Sharp, Mitchell William",M,29,1911,1972,61,61-70
1328,"Laniel, Gérald",M,32,1924,1980,56,51-60
1329,"McKenzie, A. Daniel",M,32,1924,1980,56,51-60
1330,"McRae, Paul Edmund",M,32,1924,1980,56,51-60
1331,"Neil, Douglas Charles",M,32,1924,1980,56,51-60
1332,"Nielsen, Erik",M,32,1924,1980,56,51-60
1333,"Pepin, Jean-Luc",M,32,1924,1980,56,51-60
1334,"Rose, Mark Willson",M,32,1924,1980,56,51-60
1335,"Coates, Robert Carman",M,33,1928,1984,56,51-60
1336,"Dewar, Marion",F,33,1928,1984,56,51-60
1337,"Fennell, Thomas Scott",M,33,1928,1984,56,51-60
1338,"La Salle, Roch",M,33,1928,1984,56,51-60
1339,"Paproski, Steve Eugene",M,33,1928,1984,56,51-60
1340,"Allmand, William Warren",M,34,1932,1988,56,51-60
1341,"Attewell, Bill",M,34,1932,1988,56,51-60
1342,"Bellemare, Eugène",M,34,1932,1988,56,51-60
1343,"Bird, John Williston (Bud)",M,34,1932,1988,56,51-60
1344,"Brightwell, A.H. Harry",M,34,1932,1988,56,51-60
1345,"Crawford, Rex",M,34,1932,1988,56,51-60
1346,"Horner, Robert Nesbitt",M,34,1932,1988,56,51-60
1347,"Martin, Shirley",F,34,1932,1988,56,51-60
1348,"McCurdy, Howard Douglas",M,34,1932,1988,56,51-60
1349,"Oberle, Frank",M,34,1932,1988,56,51-60
1350,"Vien, Jacques",M,34,1932,1988,56,51-60
1351,"Wilbee, Godfrey Stanley (Stan)",M,34,1932,1988,56,51-60
1352,"Althouse, Victor Fredrich (Vic)",M,35,1937,1993,56,51-60
1353,"Augustine, Jean",F,35,1937,1993,56,51-60
1354,"Mayfield, Philip William",M,35,1937,1993,56,51-60
1355,"McKinnon, Glen",M,35,1937,1993,56,51-60
1356,"Murphy, John",M,35,1937,1993,56,51-60
1357,"Ramsay, F.J. (Jack)",M,35,1937,1993,56,51-60
1358,"Terrana, Anna Marina",F,35,1937,1993,56,51-60
1359,"Tremblay, Suzanne",F,35,1937,1993,56,51-60
1360,"Alarie, Hélène",F,36,1941,1997,56,51-60
1361,"Brown, Bonnie",F,36,1941,1997,56,51-60
1362,"Fry, Hedy",F,36,1941,1997,56,51-60
1363,"Harvey, André",M,36,1941,1997,56,51-60
1364,"Johnston, F. Dale",M,36,1941,1997,56,51-60
1365,"Kilgour, David",M,36,1941,1997,56,51-60
1366,"Mills, Robert (Bob)",M,36,1941,1997,56,51-60
1367,"Peterson, James Scott (Jim)",M,36,1941,1997,56,51-60
1368,"Proctor, Dick",M,36,1941,1997,56,51-60
1369,"Stewart, Christine Susan",F,36,1941,1997,56,51-60
1370,"Beaumier, Colleen",F,37,1944,2000,56,51-60
1371,"Caplan, Elinor",F,37,1944,2000,56,51-60
1372,"Carroll, M. Aileen",F,37,1944,2000,56,51-60
1373,"Castonguay, Jeannot",M,37,1944,2000,56,51-60
1374,"Cullen, Roy",M,37,1944,2000,56,51-60
1375,"Efford, Ruben John",M,37,1944,2000,56,51-60
1376,"Goldring, Peter",M,37,1944,2000,56,51-60
1377,"Kilger, Robert (Bob)",M,37,1944,2000,56,51-60
1378,"Macklin, Paul Harold",M,37,1944,2000,56,51-60
1379,"Marcil, Serge",M,37,1944,2000,56,51-60
1380,"McDonough, Alexa",F,37,1944,2000,56,51-60
1381,"McGuire, Joseph Blair (Joe)",M,37,1944,2000,56,51-60
1382,"Rocheleau, Yves",M,37,1944,2000,56,51-60
1383,"Sgro, Judy",F,37,1944,2000,56,51-60
1384,"Alcock, Reginald B.",M,38,1948,2004,56,51-60
1385,"Cadman, Chuck",M,38,1948,2004,56,51-60
1386,"Casson, Rick",M,38,1948,2004,56,51-60
1387,"Duncan, John",M,38,1948,2004,56,51-60
1388,"Gagnon, Christiane",F,38,1948,2004,56,51-60
1389,"Gallaway, Roger John",M,38,1948,2004,56,51-60
1390,"Lee, Derek Vincent",M,38,1948,2004,56,51-60
1391,"Martin, Tony",M,38,1948,2004,56,51-60
1392,"McKay, John",M,38,1948,2004,56,51-60
1393,"Minna, Maria",F,38,1948,2004,56,51-60
1394,"O'Brien, Pat",M,38,1948,2004,56,51-60
1395,"Owen, Stephen",M,38,1948,2004,56,51-60
1396,"Szabo, Paul John Mark",M,38,1948,2004,56,51-60
1397,"White, Randy A.",M,37,1948,2000,52,51-60
1398,"Asselin, Gérard",M,39,1950,2006,56,51-60
1399,"Bennett, Carolyn",F,39,1950,2006,56,51-60
1400,"Benoit, Leon Earl",M,39,1950,2006,56,51-60
1401,"Cardin, Serge",M,39,1950,2006,56,51-60
1402,"Day, Stockwell Burt",M,39,1950,2006,56,51-60
1403,"Demers, Nicole",F,39,1950,2006,56,51-60
1404,"Fontana, Joseph Frank (Joe)",M,39,1950,2006,56,51-60
1405,"Gauthier, Michel",M,39,1950,2006,56,51-60
1406,"Hinton, Betty",F,39,1950,2006,56,51-60
1407,"Layton, Jack",M,39,1950,2006,56,51-60
1408,"McCallum, John",M,39,1950,2006,56,51-60
1409,"Obhrai, Deepak",M,39,1950,2006,56,51-60
1410,"Pearson, Glen",M,39,1950,2006,56,51-60
1411,"St. Denis, Brent",M,39,1950,2006,56,51-60
1412,"Wappel, Thomas (Tom) William",M,38,1950,2004,54,51-60
1413,"Warawa, Mark",M,38,1950,2004,54,51-60
1414,"Ashfield, Keith",M,40,1952,2008,56,51-60
1415,"Bonsant, France",F,40,1952,2008,56,51-60
1416,"Crowder, Jean",F,40,1952,2008,56,51-60
1417,"Foote, Judy",F,40,1952,2008,56,51-60
1418,"Hill, Jay D.",M,40,1952,2008,56,51-60
1419,"Maloway, Peter James (Jim)",M,40,1952,2008,56,51-60
1420,"Menzies, Ted",M,40,1952,2008,56,51-60
1421,"Nicholson, Rob",M,40,1952,2008,56,51-60
1422,"Toews, Vic",M,40,1952,2008,56,51-60
1423,"Wilfert, Bryon",M,39,1952,2006,54,51-60
1424,"Bélanger, Mauril",M,41,1955,2011,56,51-60
1425,"Boutin-Sweet, Marjolaine",F,41,1955,2011,56,51-60
1426,"Brown, Lois",F,41,1955,2011,56,51-60
1427,"Crockatt, Joan",F,41,1955,2011,56,51-60
1428,"Cuzner, Rodger",M,41,1955,2011,56,51-60
1429,"Dion, Stéphane",M,41,1955,2011,56,51-60
1430,"Dionne Labelle, Pierre",M,41,1955,2011,56,51-60
1431,"Fast, Edward",M,41,1955,2011,56,51-60
1432,"Findlay, Kerry-Lynne D.",F,41,1955,2011,56,51-60
1433,"Godin, Yvon",M,41,1955,2011,56,51-60
1434,"Karygiannis, Jim",M,41,1955,2011,56,51-60
1435,"Laverdière, Hélène",F,41,1955,2011,56,51-60
1436,"Martin, Pat",M,41,1955,2011,56,51-60
1437,"Preston, Joe",M,41,1955,2011,56,51-60
1438,"Toone, Philip",M,41,1955,2011,56,51-60
1439,"Tweed, Mervin C.",M,41,1955,2011,56,51-60
1440,"Van Kesteren, Dave",M,41,1955,2011,56,51-60
1441,"Beaulieu, Mario",M,42,1959,2015,56,51-60
1442,"Beaulieu, Mario",M,42,1959,2015,56,51-60
1443,"Benzen, Bob",M,42,1959,2015,56,51-60
1444,"Harper, Stephen",M,42,1959,2015,56,51-60
1445,"Hutchings, Gudie",F,42,1959,2015,56,51-60
1446,"Lebouthillier, Diane",F,42,1959,2015,56,51-60
1447,"McDonald, Ken",M,42,1959,2015,56,51-60
1448,"McLeod, Michael",M,42,1959,2015,56,51-60
1449,"Regan, Geoff",M,42,1959,2015,56,51-60
1450,"Samson, Darrell",M,42,1959,2015,56,51-60
1451,"Wilks, David",M,41,1959,2011,52,51-60
1452,"Casey, Sean",M,43,1963,2019,56,51-60
1453,"Davies, Don",M,43,1963,2019,56,51-60
1454,"DeBellefeuille, Claude",F,43,1963,2019,56,51-60
1455,"Desbiens, Caroline",F,43,1963,2019,56,51-60
1456,"Dowdall, Terry",M,43,1963,2019,56,51-60
1457,"Jordan, Bernadette",F,43,1963,2019,56,51-60
1458,"Lattanzio, Patricia",F,43,1963,2019,56,51-60
1459,"Long, Wayne",M,43,1963,2019,56,51-60
1460,"Mendès, Alexandra",F,43,1963,2019,56,51-60
1461,"Redekopp, Brad",M,43,1963,2019,56,51-60
1462,"Trudel, Denis",M,43,1963,2019,56,51-60
1463,"Vidal, Gary",M,43,1963,2019,56,51-60
1464,"Walker, James Edgar",M,29,1911,1972,61,61-70
1465,"Alkenbrack, Almonte Douglas",M,29,1912,1972,60,51-60
1466,"Blouin, Gustave",M,29,1912,1972,60,51-60
1467,"Drury, Charles Mills (Bud)",M,29,1912,1972,60,51-60
1468,"Hamilton, Francis Alvin George",M,29,1912,1972,60,51-60
1469,"Smith, Walter Bernard",M,29,1912,1972,60,51-60
1470,"Thomas, J. Antonio",M,29,1912,1972,60,51-60
1471,"Clermont, Gaston",M,29,1913,1972,59,51-60
1472,"Gauthier, Charles-Arthur",M,29,1913,1972,59,51-60
1473,"Hymmen, Kieth Reinhardt",M,29,1913,1972,59,51-60
1474,"Lambert, Joseph Adrien Henri",M,29,1913,1972,59,51-60
1475,"Latulippe, Henry P.",M,29,1913,1972,59,51-60
1476,"Harding, Randolph",M,29,1914,1972,58,51-60
1477,"L'Heureux, Yvon",M,29,1914,1972,58,51-60
1478,"MacLean, John Angus",M,29,1914,1972,58,51-60
1479,"Stanfield, Robert Lorne",M,29,1914,1972,58,51-60
1480,"Allard, Eudore",M,29,1915,1972,57,51-60
1481,"Madill, John Ellwood",M,29,1915,1972,57,51-60
1482,"Danforth, Harold Warren",M,29,1916,1972,56,51-60
1483,"Davis, John (Jack)",M,29,1916,1972,56,51-60
1484,"Dinsdale, Walter Gilbert",M,29,1916,1972,56,51-60
1485,"Munro, Donald W.",M,29,1916,1972,56,51-60
1486,"Thomas, Charles Humbert",M,29,1916,1972,56,51-60
1487,"Woolliams, Eldon Mattison",M,29,1916,1972,56,51-60
1488,"Caouette, David Réal",M,29,1917,1972,55,51-60
1489,"Hargrave, Herbert Thomas (Bert)",M,29,1917,1972,55,51-60
1490,"McCain, Fred Alward",M,29,1917,1972,55,51-60
1491,"McKinnon, Allan Bruce",M,29,1917,1972,55,51-60
1492,"Nelson, Nels Edwin",M,29,1917,1972,55,51-60
1493,"Boulanger, Prosper",M,29,1918,1972,54,51-60
1494,"Crouse, Lloyd Roseville",M,29,1918,1972,54,51-60
1495,"Benjamin, Leslie Gordon",M,32,1925,1980,55,51-60
1496,"Heap, Daniel James Macdonnell",M,32,1925,1980,55,51-60
1497,"Hovdebo, Stanley J.",M,32,1925,1980,55,51-60
1498,"Lawrence, Allan Frederick",M,32,1925,1980,55,51-60
1499,"MacBain, Arthur Allister",M,32,1925,1980,55,51-60
1500,"Mitchell, Margaret Anne",F,32,1925,1980,55,51-60
1501,"Rossi, Carlo",M,32,1925,1980,55,51-60
1502,"Ellis, John Raymond",M,33,1929,1984,55,51-60
1503,"Friesen, Benno",M,33,1929,1984,55,51-60
1504,"Howie, J. Robert",M,33,1929,1984,55,51-60
1505,"Shields, Jack Wendele",M,33,1929,1984,55,51-60
1506,"Turner, John Barry",M,33,1929,1984,55,51-60
1507,"Turner, John Napier",M,33,1929,1984,55,51-60
1508,"Belsher, Ross",M,34,1933,1988,55,51-60
1509,"Comuzzi, Joseph R. (Joe)",M,34,1933,1988,55,51-60
1510,"Crosby, Howard Edward",M,34,1933,1988,55,51-60
1511,"Flis, Jesse Philip",M,34,1933,1988,55,51-60
1512,"Foster, Maurice Brydon",M,34,1933,1988,55,51-60
1513,"Hicks, Robert Nelson David",M,34,1933,1988,55,51-60
1514,"Jourdenais, Fernand",M,34,1933,1988,55,51-60
1515,"Larrivée, Gaby",M,34,1933,1988,55,51-60
1516,"Weiner, Gérard (Gerry)",M,34,1933,1988,55,51-60
1517,"Bouchard, Lucien",M,35,1938,1993,55,51-60
1518,"Dalphond-Guiral, Madeleine",F,35,1938,1993,55,51-60
1519,"Debien, Maud",F,35,1938,1993,55,51-60
1520,"Harvard, John",M,35,1938,1993,55,51-60
1521,"Martin, Paul Edgar Philippe",M,35,1938,1993,55,51-60
1522,"Mifflin, Fred J.",M,35,1938,1993,55,51-60
1523,"Nunez, Osvaldo",M,35,1938,1993,55,51-60
1524,"Phinney, Elizabeth  (Beth)",F,35,1938,1993,55,51-60
1525,"Abbott, Jim",M,36,1942,1997,55,51-60
1526,"Bonin, Raymond",M,36,1942,1997,55,51-60
1527,"Cummins, John Martin",M,36,1942,1997,55,51-60
1528,"de Savoye, Pierre",M,36,1942,1997,55,51-60
1529,"Gagliano, Alfonso",M,36,1942,1997,55,51-60
1530,"Gilmour, William (Bill) Douglas",M,36,1942,1997,55,51-60
1531,"Godfrey, John Ferguson",M,36,1942,1997,55,51-60
1532,"Manning, Ernest Preston",M,36,1942,1997,55,51-60
1533,"McClelland, Ian G.",M,36,1942,1997,55,51-60
1534,"Penson, Charles Frederick (Charlie)",M,36,1942,1997,55,51-60
1535,"Provenzano, Carmen",M,36,1942,1997,55,51-60
1536,"Reynolds, John Douglas",M,36,1942,1997,55,51-60
1537,"Riis, Nelson Andrew",M,36,1942,1997,55,51-60
1538,"Steckle, Paul Daniel",M,36,1942,1997,55,51-60
1539,"Breitkreuz, Garry W.",M,37,1945,2000,55,51-60
1540,"Casey, William D. (Bill)",M,37,1945,2000,55,51-60
1541,"Elley, Reed",M,37,1945,2000,55,51-60
1542,"Fitzpatrick, Brian",M,37,1945,2000,55,51-60
1543,"Gaudet, Roger",M,37,1945,2000,55,51-60
1544,"Maloney, John",M,37,1945,2000,55,51-60
1545,"Price, David",M,37,1945,2000,55,51-60
1546,"Robillard, Lucienne",F,37,1945,2000,55,51-60
1547,"Skelton, Carol",F,37,1945,2000,55,51-60
1548,"Stinson, Darrel",M,37,1945,2000,55,51-60
1549,"Ablonczy, Diane",F,38,1949,2004,55,51-60
1550,"Bagnell, Larry",M,38,1949,2004,55,51-60
1551,"Boshcoff, Ken",M,38,1949,2004,55,51-60
1552,"Boudria, Don",M,38,1949,2004,55,51-60
1553,"Bourgeois, Diane",F,38,1949,2004,55,51-60
1554,"Bradshaw, Claudette",F,38,1949,2004,55,51-60
1555,"Easter, Wayne",M,38,1949,2004,55,51-60
1556,"Frulla, Liza",F,38,1949,2004,55,51-60
1557,"Goodale, Ralph",M,38,1949,2004,55,51-60
1558,"Komarnicki, Ed",M,38,1949,2004,55,51-60
1559,"Malhi, Gurbax Singh",M,38,1949,2004,55,51-60
1560,"Paradis, Denis",M,38,1949,2004,55,51-60
1561,"Powers, Russ",M,38,1949,2004,55,51-60
1562,"Roy, Jean-Yves",M,38,1949,2004,55,51-60
1563,"Bachand, Claude",M,39,1951,2006,55,51-60
1564,"Blaikie, William Alexander (Bill)",M,39,1951,2006,55,51-60
1565,"Cannis, John",M,39,1951,2006,55,51-60
1566,"Chan, Raymond",M,39,1951,2006,55,51-60
1567,"Jennings, Marlene",F,39,1951,2006,55,51-60
1568,"Lemay, Marc",M,39,1951,2006,55,51-60
1569,"Lukiwski, Tom",M,39,1951,2006,55,51-60
1570,"Lunney, James",M,39,1951,2006,55,51-60
1571,"Mathyssen, Irene",F,39,1951,2006,55,51-60
1572,"Murphy, Shawn",M,39,1951,2006,55,51-60
1573,"Nash, Peggy",F,39,1951,2006,55,51-60
1574,"Ratansi, Yasmin",F,39,1951,2006,55,51-60
1575,"Ritz, Gerry",M,39,1951,2006,55,51-60
1576,"Wasylycia-Leis, Judy",F,38,1951,2004,53,51-60
1577,"Allen, Malcolm",M,40,1953,2008,55,51-60
1578,"Bevington, Dennis Fraser",M,40,1953,2008,55,51-60
1579,"Brunelle, Paule",F,40,1953,2008,55,51-60
1580,"Crête, Paul",M,40,1953,2008,55,51-60
1581,"Davies, Libby",F,40,1953,2008,55,51-60
1582,"Dreeshen, Earl",M,40,1953,2008,55,51-60
1583,"Guarnieri, Albina",F,40,1953,2008,55,51-60
1584,"Guimond, Michel",M,40,1953,2008,55,51-60
1585,"Kamp, Randy",M,40,1953,2008,55,51-60
1586,"Keddy, Gerald",M,40,1953,2008,55,51-60
1587,"Merrifield, Rob",M,40,1953,2008,55,51-60
1588,"Rafferty, John",M,40,1953,2008,55,51-60
1589,"Simson, Michelle",F,40,1953,2008,55,51-60
1590,"Yelich, Lynne",F,39,1953,2006,53,51-60
1591,"Blanchette, Denis",M,41,1956,2011,55,51-60
1592,"James, Roxanne",F,41,1956,2011,55,51-60
1593,"Miller, Larry",M,41,1956,2011,55,51-60
1594,"Nunez-Melo, José",M,41,1956,2011,55,51-60
1595,"Stoffer, Peter",M,41,1956,2011,55,51-60
1596,"Vincent, Robert",M,40,1956,2008,52,51-60
1597,"Aubin, Robert",M,42,1960,2015,55,51-60
1598,"Ayoub, Ramez",M,42,1960,2015,55,51-60
1599,"Berthold, Luc",M,42,1960,2015,55,51-60
1600,"Brown, Gordon",M,42,1960,2015,55,51-60
1601,"Dhaliwal, Sukh",M,42,1960,2015,55,51-60
1602,"Eyking, Mark",M,42,1960,2015,55,51-60
1603,"Falk, Ted",M,42,1960,2015,55,51-60
1604,"Gallant, Cheryl",F,42,1960,2015,55,51-60
1605,"Jowhari, Majid",M,42,1960,2015,55,51-60
1606,"Lapointe, Linda",F,42,1960,2015,55,51-60
1607,"McGuinty, David",M,42,1960,2015,55,51-60
1608,"Philpott, Jane",F,42,1960,2015,55,51-60
1609,"Picard, Michel",M,42,1960,2015,55,51-60
1610,"Poissant, Jean-Claude",M,42,1960,2015,55,51-60
1611,"Serré, Marc G.",M,42,1960,2015,55,51-60
1612,"Thériault, Luc",M,42,1960,2015,55,51-60
1613,"Young, Wai",F,41,1960,2011,51,51-60
1614,"Badawey, Vance",M,43,1964,2019,55,51-60
1615,"Brassard, John",M,43,1964,2019,55,51-60
1616,"Deltell, Gérard",M,43,1964,2019,55,51-60
1617,"Gourde, Jacques",M,43,1964,2019,55,51-60
1618,"Maloney, James",M,43,1964,2019,55,51-60
1619,"Manly, Paul",M,43,1964,2019,55,51-60
1620,"McCauley, Kelly",M,43,1964,2019,55,51-60
1621,"Reid, Scott",M,43,1964,2019,55,51-60
1622,"Sheehan, Terry",M,43,1964,2019,55,51-60
1623,"Shipley, Doug",M,43,1964,2019,55,51-60
1624,"Yip, Jean",F,42,1964,2015,51,51-60
1625,"Yip, Jean",F,43,1964,2019,55,51-60
1626,"Yurdiga, David",M,42,1964,2015,51,51-60
1627,"Yurdiga, David",M,43,1964,2019,55,51-60
1628,"MacDonald, Daniel Joseph",M,29,1918,1972,54,51-60
1629,"MacInnis, Donald",M,29,1918,1972,54,51-60
1630,"Nesbitt, Wallace Bickford (Wally)",M,29,1918,1972,54,51-60
1631,"Orlikow, David",M,29,1918,1972,54,51-60
1632,"Ritchie, William Gordon",M,29,1918,1972,54,51-60
1633,"Whicher, Ross Mackenzie",M,29,1918,1972,54,51-60
1634,"Lambert, Marcel Joseph Aimé",M,29,1919,1972,53,51-60
1635,"Mitges, Constantine George (Gus)",M,29,1919,1972,53,51-60
1636,"Pelletier, Gérard",M,29,1919,1972,53,51-60
1637,"Towers, Thomas Gordon",M,29,1919,1972,53,51-60
1638,"Trudeau, Pierre Elliott",M,29,1919,1972,53,51-60
1639,"Trudel, Jacques L.",M,29,1919,1972,53,51-60
1640,"Whittaker, George H.",M,29,1919,1972,53,51-60
1641,"Gendron, Rosaire",M,29,1920,1972,52,51-60
1642,"Isabelle, Joseph Gaston",M,29,1920,1972,52,51-60
1643,"Lamoureux, Lucien",M,29,1920,1972,52,51-60
1644,"Masniuk, Peter Paul",M,29,1920,1972,52,51-60
1645,"Andras, Robert Knight",M,29,1921,1972,51,51-60
1646,"Danson, Barnett Jerome",M,29,1921,1972,51,51-60
1647,"Gilbert, John",M,29,1921,1972,51,51-60
1648,"Hamilton, Frank Fletcher",M,29,1921,1972,51,51-60
1649,"Jamieson, Donald Campbell",M,29,1921,1972,51,51-60
1650,"Kempling, William James",M,29,1921,1972,51,51-60
1651,"Loiselle, Gérard",M,29,1921,1972,51,51-60
1652,"Cook, Charles Henry (Chuck)",M,32,1926,1980,54,51-60
1653,"Corriveau, Léopold",M,32,1926,1980,54,51-60
1654,"Éthier, Denis",M,32,1926,1980,54,51-60
1655,"Halliday, Bruce",M,32,1926,1980,54,51-60
1656,"Blenkarn, Donald Alex",M,33,1930,1984,54,51-60
1657,"Caccia, Charles L.",M,33,1930,1984,54,51-60
1658,"Domm, William Henry (Bill)",M,33,1930,1984,54,51-60
1659,"Hopkins, Leonard Donald",M,33,1930,1984,54,51-60
1660,"Kindy, Alex",M,33,1930,1984,54,51-60
1661,"Oostrom, John Martin",M,33,1930,1984,54,51-60
1662,"Bernier, Gilles",M,34,1934,1988,54,51-60
1663,"Bernier, Gilles",M,34,1934,1988,54,51-60
1664,"Blackburn, Derek Nigel Ernest",M,34,1934,1988,54,51-60
1665,"Cardiff, Murray",M,34,1934,1988,54,51-60
1666,"Chrétien, Joseph Jacques Jean",M,34,1934,1988,54,51-60
1667,"Corbeil, Jean",M,34,1934,1988,54,51-60
1668,"Fisher, Ron",M,34,1934,1988,54,51-60
1669,"Hawkes, Frederick James (Jim)",M,34,1934,1988,54,51-60
1670,"Hnatyshyn, Ramon John",M,34,1934,1988,54,51-60
1671,"James, Kenneth Albert",M,34,1934,1988,54,51-60
1672,"MacLaren, Roy",M,34,1934,1988,54,51-60
1673,"Axworthy, Lloyd",M,35,1939,1993,54,51-60
1674,"Catterall, Marlene",F,35,1939,1993,54,51-60
1675,"Epp, Ken",M,35,1939,1993,54,51-60
1676,"Graham, Bill",M,35,1939,1993,54,51-60
1677,"Jackson, Ovid L.",M,35,1939,1993,54,51-60
1678,"Jennings, Daphne G.",F,35,1939,1993,54,51-60
1679,"Ouellet, André",M,35,1939,1993,54,51-60
1680,"Payne, Jean",F,35,1939,1993,54,51-60
1681,"Péloquin, Gaston",M,35,1939,1993,54,51-60
1682,"Proud, George Albert",M,35,1939,1993,54,51-60
1683,"Simmons, Roger",M,35,1939,1993,54,51-60
1684,"Bryden, John H.",M,36,1943,1997,54,51-60
1685,"Earle, Gordon S.",M,36,1943,1997,54,51-60
1686,"Girard-Bujold, Jocelyne",F,36,1943,1997,54,51-60
1687,"Hanger, Art",M,36,1943,1997,54,51-60
1688,"Hearn, Loyola",M,36,1943,1997,54,51-60
1689,"Konrad, Derrek P.",M,36,1943,1997,54,51-60
1690,"Lefebvre, Réjean",M,36,1943,1997,54,51-60
1691,"Marleau, Diane",F,36,1943,1997,54,51-60
1692,"Normand, Gilbert",M,36,1943,1997,54,51-60
1693,"Patry, Bernard",M,36,1943,1997,54,51-60
1694,"Plamondon, Louis",M,36,1943,1997,54,51-60
1695,"Vanclief, Lyle",M,36,1943,1997,54,51-60
1696,"Chatters, David Cameron",M,37,1946,2000,54,51-60
1697,"Collenette, David Michael",M,37,1946,2000,54,51-60
1698,"DeVillers, Paul",M,37,1946,2000,54,51-60
1699,"Forseth, Paul Eugene",M,37,1946,2000,54,51-60
1700,"Gouk, James William (Jim)",M,37,1946,2000,54,51-60
1701,"Lebel, Ghislain",M,37,1946,2000,54,51-60
1702,"MacAulay, Lawrence",M,37,1946,2000,54,51-60
1703,"Milliken, Peter Andrew Stewart",M,37,1946,2000,54,51-60
1704,"Mills, Dennis Joseph",M,37,1946,2000,54,51-60
1705,"Nystrom, Lorne Edmund",M,37,1946,2000,54,51-60
1706,"Parrish, Carolyn",F,37,1946,2000,54,51-60
1707,"Proulx, Marcel",M,37,1946,2000,54,51-60
1708,"Shepherd, Alexander James",M,37,1946,2000,54,51-60
1709,"Telegdi, Andrew",M,37,1946,2000,54,51-60
1710,"Ur, Rose-Marie Margaret",F,37,1946,2000,54,51-60
1711,"Asselin, Gérard",M,38,1950,2004,54,51-60
1712,"Bennett, Carolyn",F,38,1950,2004,54,51-60
1713,"Benoit, Leon Earl",M,38,1950,2004,54,51-60
1714,"Cardin, Serge",M,38,1950,2004,54,51-60
1715,"Day, Stockwell Burt",M,38,1950,2004,54,51-60
1716,"Demers, Nicole",F,38,1950,2004,54,51-60
1717,"Fontana, Joseph Frank (Joe)",M,38,1950,2004,54,51-60
1718,"Gauthier, Michel",M,38,1950,2004,54,51-60
1719,"Hinton, Betty",F,38,1950,2004,54,51-60
1720,"Layton, Jack",M,38,1950,2004,54,51-60
1721,"McCallum, John",M,38,1950,2004,54,51-60
1722,"McLellan, A. Anne",F,38,1950,2004,54,51-60
1723,"Obhrai, Deepak",M,38,1950,2004,54,51-60
1724,"St. Denis, Brent",M,38,1950,2004,54,51-60
1725,"Wappel, Thomas (Tom) William",M,37,1950,2000,50,41-50
1726,"Barnes, Susan (Sue)",F,39,1952,2006,54,51-60
1727,"Bonsant, France",F,39,1952,2006,54,51-60
1728,"Chamberlain, Brenda",F,39,1952,2006,54,51-60
1729,"Crowder, Jean",F,39,1952,2006,54,51-60
1730,"Gravel, Raymond",M,39,1952,2006,54,51-60
1731,"Hill, Jay D.",M,39,1952,2006,54,51-60
1732,"Menzies, Ted",M,39,1952,2006,54,51-60
1733,"Nicholson, Rob",M,39,1952,2006,54,51-60
1734,"St. Amand, Lloyd",M,39,1952,2006,54,51-60
1735,"Toews, Vic",M,39,1952,2006,54,51-60
1736,"Wilfert, Bryon",M,38,1952,2004,52,51-60
1737,"Blais, Raynald",M,40,1954,2008,54,51-60
1738,"Christopherson, David",M,40,1954,2008,54,51-60
1739,"Holder, Ed",M,40,1954,2008,54,51-60
1740,"Lavallée, Carole",F,40,1954,2008,54,51-60
1741,"Lebel, Denis",M,40,1954,2008,54,51-60
1742,"McColeman, Phil",M,40,1954,2008,54,51-60
1743,"Mulcair, Thomas J.",M,40,1954,2008,54,51-60
1744,"Murray, Joyce",F,40,1954,2008,54,51-60
1745,"Valeriote, Frank",M,40,1954,2008,54,51-60
1746,"Anderson, David",M,41,1957,2011,54,51-60
1747,"Anderson, David",M,41,1957,2011,54,51-60
1748,"Bateman, Joyce",F,41,1957,2011,54,51-60
1749,"Chisholm, Robert",M,41,1957,2011,54,51-60
1750,"Chow, Olivia",F,41,1957,2011,54,51-60
1751,"Finley, Diane",F,41,1957,2011,54,51-60
1752,"Goguen, Robert",M,41,1957,2011,54,51-60
1753,"McLeod, Cathy",F,41,1957,2011,54,51-60
1754,"Scarpaleggia, Francis",M,41,1957,2011,54,51-60
1755,"Stanton, Bruce",M,41,1957,2011,54,51-60
1756,"Sweet, David",M,41,1957,2011,54,51-60
1757,"Block, Kelly",F,42,1961,2015,54,51-60
1758,"Clement, Tony",M,42,1961,2015,54,51-60
1759,"Goldsmith-Jones, Pamela",F,42,1961,2015,54,51-60
1760,"Hardcastle, Cheryl",F,42,1961,2015,54,51-60
1761,"Kwan, Jenny Wai Ching",F,42,1961,2015,54,51-60
1762,"Martel, Richard",M,42,1961,2015,54,51-60
1763,"Rota, Anthony",M,42,1961,2015,54,51-60
1764,"Saganash, Romeo",M,42,1961,2015,54,51-60
1765,"Vaughan, Adam",M,41,1961,2011,50,41-50
1766,"Vaughan, Adam",M,42,1961,2015,54,51-60
1767,"Allison, Dean",M,43,1965,2019,54,51-60
1768,"Bergeron, Stéphane",M,43,1965,2019,54,51-60
1769,"Bezan, James",M,43,1965,2019,54,51-60
1770,"Blanchet, Yves-François",M,43,1965,2019,54,51-60
1771,"Blaney, Steven",M,43,1965,2019,54,51-60
1772,"Duclos, Jean-Yves",M,43,1965,2019,54,51-60
1773,"Fisher, Darren",M,43,1965,2019,54,51-60
1774,"Godin, Joël",M,43,1965,2019,54,51-60
1775,"Iacono, Angelo",M,43,1965,2019,54,51-60
1776,"Wilkinson, Jonathan",M,42,1965,2015,50,41-50
1777,"Wilkinson, Jonathan",M,43,1965,2019,54,51-60
1778,"Stewart, Ronald Alexander",M,32,1927,1980,53,51-60
1779,"Mackasey, Bryce Stuart",M,29,1921,1972,51,51-60
1780,"Morin, Albanie",F,29,1921,1972,51,51-60
1781,"Neale, Charles Patrick (Paddy)",M,29,1921,1972,51,51-60
1782,"Saltsman, Max",M,29,1921,1972,51,51-60
1783,"Scott, William C.",M,29,1921,1972,51,51-60
1784,"Smith, G.A. Percy",M,29,1921,1972,51,51-60
1785,"Alexander, Lincoln MacCauley",M,29,1922,1972,50,41-50
1786,"Béchard, Albert",M,29,1922,1972,50,41-50
1787,"Cyr, Alexandre",M,29,1922,1972,50,41-50
1788,"Gillespie, Alastair William",M,29,1922,1972,50,41-50
1789,"Herbert, Harold Thomas",M,29,1922,1972,50,41-50
1790,"McCleave, Robert Jardine",M,29,1922,1972,50,41-50
1791,"Peters, William Arnold",M,29,1922,1972,50,41-50
1792,"Richardson, James Armstrong",M,29,1922,1972,50,41-50
1793,"Sauvé, Jeanne",F,29,1922,1972,50,41-50
1794,"Skoreyko, William",M,29,1922,1972,50,41-50
1795,"Yanakis, Antonio",M,29,1922,1972,50,41-50
1796,"Bell, Thomas Miller",M,29,1923,1972,49,41-50
1797,"Dupras, Maurice",M,29,1923,1972,49,41-50
1798,"Fairweather, Robert Gordon Lee",M,29,1923,1972,49,41-50
1799,"Frank, William Charles",M,29,1923,1972,49,41-50
1800,"Hellyer, Paul Theodore",M,29,1923,1972,49,41-50
1801,"Morgan, J. Trevor",M,29,1923,1972,49,41-50
1802,"Roy, Jean Robert",M,29,1923,1972,49,41-50
1803,"Arrol, Ian MacLachlan",M,29,1924,1972,48,41-50
1804,"Beaudoin, Léonel",M,29,1924,1972,48,41-50
1805,"Gillies, James McPhail",M,29,1924,1972,48,41-50
1806,"Laniel, Gérald",M,29,1924,1972,48,41-50
1807,"McKenzie, A. Daniel",M,29,1924,1972,48,41-50
1808,"McRae, Paul Edmund",M,29,1924,1972,48,41-50
1809,"Neil, Douglas Charles",M,29,1924,1972,48,41-50
1810,"Nielsen, Erik",M,29,1924,1972,48,41-50
1811,"Rose, Mark Willson",M,29,1924,1972,48,41-50
1812,"Benjamin, Leslie Gordon",M,29,1925,1972,47,41-50
1813,"Howard, Frank",M,29,1925,1972,47,41-50
1814,"Laflamme, Ovide",M,29,1925,1972,47,41-50
1815,"Laprise, Gérard",M,29,1925,1972,47,41-50
1816,"Cossitt, Thomas Charles",M,32,1927,1980,53,51-60
1817,"Cullen, Jack Sydney George (Bud)",M,32,1927,1980,53,51-60
1818,"de Corneille, Roland",M,32,1927,1980,53,51-60
1819,"Fretz, Claude Girvin (Girve)",M,32,1927,1980,53,51-60
1820,"Killens, Marie Thérèse Rollande",F,32,1927,1980,53,51-60
1821,"Nicholson, Aideen",F,32,1927,1980,53,51-60
1822,"Robinson, William Kenneth",M,32,1927,1980,53,51-60
1823,"Savard, Pierre Raymond",M,32,1927,1980,53,51-60
1824,"Stevens, Sinclair McKnight",M,32,1927,1980,53,51-60
1825,"Crosbie, John Carnell",M,33,1931,1984,53,51-60
1826,"Fraleigh, Sidney Arthur",M,33,1931,1984,53,51-60
1827,"Fraser, John Allen",M,33,1931,1984,53,51-60
1828,"Gray, Herbert Eser (Herb)",M,33,1931,1984,53,51-60
1829,"Guilbault, Jean-Guy",M,33,1931,1984,53,51-60
1830,"Merrithew, Gerald Stairs",M,33,1931,1984,53,51-60
1831,"Nowlan, John Patrick (Pat)",M,33,1931,1984,53,51-60
1832,"Feltham, Louise",F,34,1935,1988,53,51-60
1833,"Mazankowski, Donald Frank",M,34,1935,1988,53,51-60
1834,"Pagtakhan, Rey D.",M,34,1935,1988,53,51-60
1835,"Parent, Gilbert",M,34,1935,1988,53,51-60
1836,"Redway, Alan",M,34,1935,1988,53,51-60
1837,"Rocheleau, Gilles",M,34,1935,1988,53,51-60
1838,"Sparrow, Barbara Jane (Bobbie)",F,34,1935,1988,53,51-60
1839,"Vézina, Monique",F,34,1935,1988,53,51-60
1840,"Wise, John",M,33,1935,1984,49,41-50
1841,"Assad, Mark Joseph",M,35,1940,1993,53,51-60
1842,"Bhaduria, Jag",M,35,1940,1993,53,51-60
1843,"Breitkreuz, Cliff N.",M,35,1940,1993,53,51-60
1844,"Bridgman, Margaret",F,35,1940,1993,53,51-60
1845,"Fillion, Gilbert",M,35,1940,1993,53,51-60
1846,"Hubbard, Charles",M,35,1940,1993,53,51-60
1847,"Lalonde, Francine",F,35,1940,1993,53,51-60
1848,"Lastewka, Walt",M,35,1940,1993,53,51-60
1849,"Laurin, René",M,35,1940,1993,53,51-60
1850,"MacLellan, Russell Gregoire",M,35,1940,1993,53,51-60
1851,"Massé, Marcel",M,35,1940,1993,53,51-60
1852,"McCormick, Larry",M,35,1940,1993,53,51-60
1853,"O'Reilly, John Francis",M,35,1940,1993,53,51-60
1854,"Pickard, Jerry",M,35,1940,1993,53,51-60
1855,"Wood, Bob",M,34,1940,1988,48,41-50
1856,"Young, M. Douglas",M,34,1940,1988,48,41-50
1857,"Beaumier, Colleen",F,36,1944,1997,53,51-60
1858,"Caplan, Elinor",F,36,1944,1997,53,51-60
1859,"Carroll, M. Aileen",F,36,1944,1997,53,51-60
1860,"Cullen, Roy",M,36,1944,1997,53,51-60
1861,"Goldring, Peter",M,36,1944,1997,53,51-60
1862,"Kilger, Robert (Bob)",M,36,1944,1997,53,51-60
1863,"Marchand, Jean-Paul",M,36,1944,1997,53,51-60
1864,"McDonough, Alexa",F,36,1944,1997,53,51-60
1865,"McGuire, Joseph Blair (Joe)",M,36,1944,1997,53,51-60
1866,"Rocheleau, Yves",M,36,1944,1997,53,51-60
1867,"Sgro, Judy",F,36,1944,1997,53,51-60
1868,"Comartin, Joe",M,37,1947,2000,53,51-60
1869,"Dubé, Antoine",M,37,1947,2000,53,51-60
1870,"Duceppe, Gilles",M,37,1947,2000,53,51-60
1871,"Hilstrom, Howard E.",M,37,1947,2000,53,51-60
1872,"Longfield, Judi",F,37,1947,2000,53,51-60
1873,"Mahoney, Steve",M,37,1947,2000,53,51-60
1874,"Mark, Inky",M,37,1947,2000,53,51-60
1875,"Matthews, Bill",M,37,1947,2000,53,51-60
1876,"Picard, Pauline",F,37,1947,2000,53,51-60
1877,"Rock, Allan",M,37,1947,2000,53,51-60
1878,"Saada, Jacques",M,37,1947,2000,53,51-60
1879,"Thompson, Gregory Francis",M,37,1947,2000,53,51-60
1880,"Bachand, Claude",M,38,1951,2004,53,51-60
1881,"Blaikie, William Alexander (Bill)",M,38,1951,2004,53,51-60
1882,"Blondin-Andrew, Ethel Dorothy",F,38,1951,2004,53,51-60
1883,"Cannis, John",M,38,1951,2004,53,51-60
1884,"Chan, Raymond",M,38,1951,2004,53,51-60
1885,"Desrochers, Odina",M,38,1951,2004,53,51-60
1886,"Godbout, Marc",M,38,1951,2004,53,51-60
1887,"Jennings, Marlene",F,38,1951,2004,53,51-60
1888,"Lemay, Marc",M,38,1951,2004,53,51-60
1889,"Lukiwski, Tom",M,38,1951,2004,53,51-60
1890,"Lunney, James",M,38,1951,2004,53,51-60
1891,"Murphy, Shawn",M,38,1951,2004,53,51-60
1892,"Myers, Lynn",M,38,1951,2004,53,51-60
1893,"O'Brien, Lawrence D.",M,38,1951,2004,53,51-60
1894,"Pettigrew, Pierre Stewart",M,38,1951,2004,53,51-60
1895,"Ratansi, Yasmin",F,38,1951,2004,53,51-60
1896,"Ritz, Gerry",M,38,1951,2004,53,51-60
1897,"Wasylycia-Leis, Judy",F,37,1951,2000,49,41-50
1898,"Bevington, Dennis Fraser",M,39,1953,2006,53,51-60
1899,"Brunelle, Paule",F,39,1953,2006,53,51-60
1900,"Crête, Paul",M,39,1953,2006,53,51-60
1901,"Davies, Libby",F,39,1953,2006,53,51-60
1902,"Guarnieri, Albina",F,39,1953,2006,53,51-60
1903,"Guimond, Michel",M,39,1953,2006,53,51-60
1904,"Kadis, Susan",F,39,1953,2006,53,51-60
1905,"Kamp, Randy",M,39,1953,2006,53,51-60
1906,"Keddy, Gerald",M,39,1953,2006,53,51-60
1907,"Merrifield, Rob",M,39,1953,2006,53,51-60
1908,"Redman, Karen",F,39,1953,2006,53,51-60
1909,"Yelich, Lynne",F,38,1953,2004,51,51-60
1910,"Bélanger, Mauril",M,40,1955,2008,53,51-60
1911,"Brown, Lois",F,40,1955,2008,53,51-60
1912,"Cuzner, Rodger",M,40,1955,2008,53,51-60
1913,"Dion, Stéphane",M,40,1955,2008,53,51-60
1914,"Fast, Edward",M,40,1955,2008,53,51-60
1915,"Godin, Yvon",M,40,1955,2008,53,51-60
1916,"Karygiannis, Jim",M,40,1955,2008,53,51-60
1917,"Martin, Pat",M,40,1955,2008,53,51-60
1918,"Paquette, Pierre A.",M,40,1955,2008,53,51-60
1919,"Preston, Joe",M,40,1955,2008,53,51-60
1920,"Siksay, Bill",M,40,1955,2008,53,51-60
1921,"Tweed, Mervin C.",M,40,1955,2008,53,51-60
1922,"Van Kesteren, Dave",M,40,1955,2008,53,51-60
1923,"Vellacott, Maurice",M,39,1955,2006,51,51-60
1924,"Vellacott, Maurice",M,40,1955,2008,53,51-60
1925,"Benskin, Tyrone",M,41,1958,2011,53,51-60
1926,"Dechert, Bob",M,41,1958,2011,53,51-60
1927,"Dubourg, Emmanuel",M,41,1958,2011,53,51-60
1928,"Giguère, Alain",M,41,1958,2011,53,51-60
1929,"Goodyear, Gary",M,41,1958,2011,53,51-60
1930,"Grewal, Nina",F,41,1958,2011,53,51-60
1931,"Hayes, Bryan",M,41,1958,2011,53,51-60
1932,"Hughes, Carol",F,41,1958,2011,53,51-60
1933,"LeBlanc, Hélène",F,41,1958,2011,53,51-60
1934,"Pilon, François",M,41,1958,2011,53,51-60
1935,"Shory, Devinder",M,41,1958,2011,53,51-60
1936,"Sorenson, Kevin",M,41,1958,2011,53,51-60
1937,"Weston, John",M,40,1958,2008,50,41-50
1938,"Angus, Charlie",M,42,1962,2015,53,51-60
1939,"Baylis, Frank",M,42,1962,2015,53,51-60
1940,"Boucher, Sylvie",F,42,1962,2015,53,51-60
1941,"Carrie, Colin",M,42,1962,2015,53,51-60
1942,"Ellis, Neil R.",M,42,1962,2015,53,51-60
1943,"Généreux, Bernard",M,42,1962,2015,53,51-60
1944,"Jolibois, Georgina",F,42,1962,2015,53,51-60
1945,"Julian, Peter",M,42,1962,2015,53,51-60
1946,"Lametti, David",M,42,1962,2015,53,51-60
1947,"Lamoureux, Kevin",M,42,1962,2015,53,51-60
1948,"Morneau, Bill",M,42,1962,2015,53,51-60
1949,"Ruimy, Dan",M,42,1962,2015,53,51-60
1950,"Aboultaif, Ziad",M,43,1966,2019,53,51-60
1951,"Brière, Élisabeth",F,43,1966,2019,53,51-60
1952,"Champoux, Martin",M,43,1966,2019,53,51-60
1953,"Fillmore, Andy",M,43,1966,2019,53,51-60
1954,"Fonseca, Peter",M,43,1966,2019,53,51-60
1955,"Hajdu, Patricia",F,43,1966,2019,53,51-60
1956,"Jansen, Tamara",F,43,1966,2019,53,51-60
1957,"Lauzon, Stéphane",M,43,1966,2019,53,51-60
1958,"MacKinnon, Steven",M,43,1966,2019,53,51-60
1959,"Soroka, Gerald",M,43,1966,2019,53,51-60
1960,"Spengemann, Sven",M,43,1966,2019,53,51-60
1961,"Therrien, Alain",M,43,1966,2019,53,51-60
1962,"Lawrence, Allan Frederick",M,29,1925,1972,47,41-50
1963,"Stackhouse, Reginald Francis",M,29,1925,1972,47,41-50
1964,"Corriveau, Léopold",M,29,1926,1972,46,41-50
1965,"Dubé, Jean-Eudes",M,29,1926,1972,46,41-50
1966,"Éthier, Denis",M,29,1926,1972,46,41-50
1967,"Godin, Roland",M,29,1926,1972,46,41-50
1968,"Lachance, Georges-C.",M,29,1926,1972,46,41-50
1969,"Langlois, Paul",M,29,1926,1972,46,41-50
1970,"Lessard, Marcel",M,29,1926,1972,46,41-50
1971,"Cossitt, Thomas Charles",M,29,1927,1972,45,41-50
1972,"Cullen, Jack Sydney George (Bud)",M,29,1927,1972,45,41-50
1973,"Hollands, Daniel Fulton",M,29,1927,1972,45,41-50
1974,"Holmes, John Robert",M,29,1927,1972,45,41-50
1975,"Horner, John (Jack) Henry",M,29,1927,1972,45,41-50
1976,"Stevens, Sinclair McKnight",M,29,1927,1972,45,41-50
1977,"Cafik, Norman Augustine",M,29,1928,1972,44,41-50
1978,"Coates, Robert Carman",M,29,1928,1972,44,41-50
1979,"Grafftey, William Heward",M,29,1928,1972,44,41-50
1980,"Hurlburt, Kenneth Earl",M,29,1928,1972,44,41-50
1981,"La Salle, Roch",M,29,1928,1972,44,41-50
1982,"Lajoie, Claude G.",M,29,1928,1972,44,41-50
1983,"Marceau, Gilles",M,29,1928,1972,44,41-50
1984,"McKinley, Robert Elgin",M,29,1928,1972,44,41-50
1985,"Paproski, Steve Eugene",M,29,1928,1972,44,41-50
1986,"Portelance, Arthur",M,29,1928,1972,44,41-50
1987,"Rondeau, Gilbert F.",M,29,1928,1972,44,41-50
1988,"Stewart, Donald Craig",M,29,1928,1972,44,41-50
1989,"Côté, Florian",M,29,1929,1972,43,41-50
1990,"Bawden, Peter Colwell",M,29,1929,1972,43,41-50
1991,"Beattie, Duncan M.",M,29,1929,1972,43,41-50
1992,"Buchanan, J. Judd",M,29,1929,1972,43,41-50
1993,"Carter, Walter C.",M,29,1929,1972,43,41-50
1994,"Comtois, Joseph-Roland",M,29,1929,1972,43,41-50
1995,"Ellis, John Raymond",M,29,1929,1972,43,41-50
1996,"Howie, J. Robert",M,29,1929,1972,43,41-50
1997,"Korchinski, Stanley James",M,29,1929,1972,43,41-50
1998,"Kuntz, Harry",M,29,1929,1972,43,41-50
1999,"Coates, Robert Carman",M,32,1928,1980,52,51-60
2000,"Fennell, Thomas Scott",M,32,1928,1980,52,51-60
2001,"Gilchrist, James Gordon",M,32,1928,1980,52,51-60
2002,"La Salle, Roch",M,32,1928,1980,52,51-60
2003,"Lajoie, Claude G.",M,32,1928,1980,52,51-60
2004,"Marceau, Gilles",M,32,1928,1980,52,51-60
2005,"Ogle, Robert Joseph",M,32,1928,1980,52,51-60
2006,"Paproski, Steve Eugene",M,32,1928,1980,52,51-60
2007,"Portelance, Arthur",M,32,1928,1980,52,51-60
2008,"Regan, Gerald Augustine",M,32,1928,1980,52,51-60
2009,"Thomson, John William",M,32,1928,1980,52,51-60
2010,"Weatherhead, David Bennington",M,32,1928,1980,52,51-60
2011,"Allmand, William Warren",M,33,1932,1984,52,51-60
2012,"Attewell, Bill",M,33,1932,1984,52,51-60
2013,"Brightwell, A.H. Harry",M,33,1932,1984,52,51-60
2014,"Hardey, Elliott William",M,33,1932,1984,52,51-60
2015,"Horner, Robert Nesbitt",M,33,1932,1984,52,51-60
2016,"Johnson, Morrissey",M,33,1932,1984,52,51-60
2017,"Manly, James Douglas",M,33,1932,1984,52,51-60
2018,"Martin, Shirley",F,33,1932,1984,52,51-60
2019,"McCurdy, Howard Douglas",M,33,1932,1984,52,51-60
2020,"McGrath, James Aloysius",M,33,1932,1984,52,51-60
2021,"Oberle, Frank",M,33,1932,1984,52,51-60
2022,"Brewin, John F.",M,34,1936,1988,52,51-60
2023,"Broadbent, John Edward",M,34,1936,1988,52,51-60
2024,"Clark, Walter Leland Rutherford (Lee)",M,34,1936,1988,52,51-60
2025,"Dionne, Maurice Adrian",M,34,1936,1988,52,51-60
2026,"Edwards, James (Jim) Stewart",M,34,1936,1988,52,51-60
2027,"Joncas, Jean-Luc",M,34,1936,1988,52,51-60
2028,"Kaplan, Robert Phillip",M,34,1936,1988,52,51-60
2029,"MacDonald, David Samuel Horne",M,34,1936,1988,52,51-60
2030,"MacKay, Elmer MacIntosh",M,34,1936,1988,52,51-60
2031,"Masse, Marcel",M,34,1936,1988,52,51-60
2032,"Mayer, Charles James",M,34,1936,1988,52,51-60
2033,"McLaughlin, Audrey Marlene",F,34,1936,1988,52,51-60
2034,"McLean, Walter Franklin",M,34,1936,1988,52,51-60
2035,"Reimer, John Henry",M,34,1936,1988,52,51-60
2036,"Tardif, Monique Bernatchez",F,34,1936,1988,52,51-60
2037,"Brown, Bonnie",F,35,1941,1993,52,51-60
2038,"Cowling, Marlene",F,35,1941,1993,52,51-60
2039,"Fewchuk, Ron",M,35,1941,1993,52,51-60
2040,"Fry, Hedy",F,35,1941,1993,52,51-60
2041,"Johnston, F. Dale",M,35,1941,1993,52,51-60
2042,"Kilgour, David",M,35,1941,1993,52,51-60
2043,"Leblanc, Nic",M,35,1941,1993,52,51-60
2044,"Mills, Robert (Bob)",M,35,1941,1993,52,51-60
2045,"Peterson, James Scott (Jim)",M,35,1941,1993,52,51-60
2046,"Stewart, Christine Susan",F,35,1941,1993,52,51-60
2047,"Breitkreuz, Garry W.",M,36,1945,1997,52,51-60
2048,"Casey, William D. (Bill)",M,36,1945,1997,52,51-60
2049,"Elley, Reed",M,36,1945,1997,52,51-60
2050,"Maloney, John",M,36,1945,1997,52,51-60
2051,"Price, David",M,36,1945,1997,52,51-60
2052,"Robillard, Lucienne",F,36,1945,1997,52,51-60
2053,"Stinson, Darrel",M,36,1945,1997,52,51-60
2054,"Venne, Pierrette",F,36,1945,1997,52,51-60
2055,"Alcock, Reginald B.",M,37,1948,2000,52,51-60
2056,"Assadourian, Sarkis",M,37,1948,2000,52,51-60
2057,"Cadman, Chuck",M,37,1948,2000,52,51-60
2058,"Casson, Rick",M,37,1948,2000,52,51-60
2059,"Duncan, John",M,37,1948,2000,52,51-60
2060,"Gagnon, Christiane",F,37,1948,2000,52,51-60
2061,"Gallaway, Roger John",M,37,1948,2000,52,51-60
2062,"Lee, Derek Vincent",M,37,1948,2000,52,51-60
2063,"McKay, John",M,37,1948,2000,52,51-60
2064,"Minna, Maria",F,37,1948,2000,52,51-60
2065,"O'Brien, Pat",M,37,1948,2000,52,51-60
2066,"Owen, Stephen",M,37,1948,2000,52,51-60
2067,"Szabo, Paul John Mark",M,37,1948,2000,52,51-60
2068,"White, Randy A.",M,36,1948,1997,49,41-50
2069,"Barnes, Susan (Sue)",F,38,1952,2004,52,51-60
2070,"Bonsant, France",F,38,1952,2004,52,51-60
2071,"Chamberlain, Brenda",F,38,1952,2004,52,51-60
2072,"Crowder, Jean",F,38,1952,2004,52,51-60
2073,"Hill, Jay D.",M,38,1952,2004,52,51-60
2074,"Menzies, Ted",M,38,1952,2004,52,51-60
2075,"Nicholson, Rob",M,38,1952,2004,52,51-60
2076,"St. Amand, Lloyd",M,38,1952,2004,52,51-60
2077,"Toews, Vic",M,38,1952,2004,52,51-60
2078,"Wilfert, Bryon",M,37,1952,2000,48,41-50
2079,"Bell, Catherine",F,39,1954,2006,52,51-60
2080,"Blais, Raynald",M,39,1954,2006,52,51-60
2081,"Christopherson, David",M,39,1954,2006,52,51-60
2082,"Lavallée, Carole",F,39,1954,2006,52,51-60
2083,"Lebel, Denis",M,39,1954,2006,52,51-60
2084,"Mulcair, Thomas J.",M,39,1954,2006,52,51-60
2085,"Murray, Joyce",F,39,1954,2006,52,51-60
2086,"Pallister, Brian William",M,39,1954,2006,52,51-60
2087,"Temelkovski, Lui",M,39,1954,2006,52,51-60
2088,"Miller, Larry",M,40,1956,2008,52,51-60
2089,"Oliphant, Robert",M,40,1956,2008,52,51-60
2090,"Prentice, Jim",M,40,1956,2008,52,51-60
2091,"Stoffer, Peter",M,40,1956,2008,52,51-60
2092,"Vincent, Robert",M,39,1956,2006,50,41-50
2093,"Zed, Paul",M,39,1956,2006,50,41-50
2094,"Adler, Mark",M,41,1959,2011,52,51-60
2095,"Harper, Stephen",M,41,1959,2011,52,51-60
2096,"Menegakis, Costas",M,41,1959,2011,52,51-60
2097,"Regan, Geoff",M,41,1959,2011,52,51-60
2098,"Shea, Gail",F,41,1959,2011,52,51-60
2099,"Truppe, Susan",F,41,1959,2011,52,51-60
2100,"Aldag, John",M,42,1963,2015,52,51-60
2101,"Bernier, Maxime",M,42,1963,2015,52,51-60
2102,"Casey, Sean",M,42,1963,2015,52,51-60
2103,"Davies, Don",M,42,1963,2015,52,51-60
2104,"Jordan, Bernadette",F,42,1963,2015,52,51-60
2105,"Long, Wayne",M,42,1963,2015,52,51-60
2106,"Mendès, Alexandra",F,42,1963,2015,52,51-60
2107,"Nantel, Pierre",M,42,1963,2015,52,51-60
2108,"Peschisolido, Joe",M,42,1963,2015,52,51-60
2109,"Tootoo, Hunter",M,42,1963,2015,52,51-60
2110,"Van Loan, Peter",M,42,1963,2015,52,51-60
2111,"Wallace, Mike",M,41,1963,2011,48,41-50
2112,"Anand, Anita",F,43,1967,2019,52,51-60
2113,"Gray, Tracy",F,43,1967,2019,52,51-60
2114,"Hoback, Randy",M,43,1967,2019,52,51-60
2115,"LeBlanc, Dominic",M,43,1967,2019,52,51-60
2116,"Rodriguez, Pablo",M,43,1967,2019,52,51-60
2117,"Saini, Raj",M,43,1967,2019,52,51-60
2118,"Greenaway, Lorne Everett",M,33,1933,1984,51,51-60
2119,"Lalonde, Marc",M,29,1929,1972,43,41-50
2120,"Olaussen, Harry Magnus",M,29,1929,1972,43,41-50
2121,"Stanbury, Robert Douglas George",M,29,1929,1972,43,41-50
2122,"Stewart, Ralph Wesley",M,29,1929,1972,43,41-50
2123,"Turner, John Napier",M,29,1929,1972,43,41-50
2124,"Baker, Walter David",M,29,1930,1972,42,41-50
2125,"Blenkarn, Donald Alex",M,29,1930,1972,42,41-50
2126,"Caccia, Charles L.",M,29,1930,1972,42,41-50
2127,"Hopkins, Leonard Donald",M,29,1930,1972,42,41-50
2128,"Horner, Norval Alic",M,29,1930,1972,42,41-50
2129,"Jarvis, William Herbert",M,29,1930,1972,42,41-50
2130,"Fraser, John Allen",M,29,1931,1972,41,41-50
2131,"Gray, Herbert Eser (Herb)",M,29,1931,1972,41,41-50
2132,"Harney, John Paul",M,29,1931,1972,41,41-50
2133,"Leggatt, Stuart Malcolm",M,29,1931,1972,41,41-50
2134,"MacGuigan, Mark R.",M,29,1931,1972,41,41-50
2135,"Munro, John Carr",M,29,1931,1972,41,41-50
2136,"Nesdoly, Elias (Eli)",M,29,1931,1972,41,41-50
2137,"Nowlan, John Patrick (Pat)",M,29,1931,1972,41,41-50
2138,"Poulin, Fabian Hugh",M,29,1931,1972,41,41-50
2139,"Taylor, Charles Keith",M,29,1931,1972,41,41-50
2140,"Allmand, William Warren",M,29,1932,1972,40,31-40
2141,"Basford, Stanley Ronald",M,29,1932,1972,40,31-40
2142,"Goyer, Jean-Pierre",M,29,1932,1972,40,31-40
2143,"Lang, Otto Emil",M,29,1932,1972,40,31-40
2144,"Macdonald, Donald Stovel",M,29,1932,1972,40,31-40
2145,"McGrath, James Aloysius",M,29,1932,1972,40,31-40
2146,"Appolloni, Ursula",F,32,1929,1980,51,51-60
2147,"Bloomfield, Garnet McCallum",M,32,1929,1980,51,51-60
2148,"Bossy, Maurice Louis",M,32,1929,1980,51,51-60
2149,"Buchanan, J. Judd",M,32,1929,1980,51,51-60
2150,"Burghardt, John O. (Jack)",M,32,1929,1980,51,51-60
2151,"Comtois, Joseph-Roland",M,32,1929,1980,51,51-60
2152,"Ellis, John Raymond",M,32,1929,1980,51,51-60
2153,"Ferguson, Ralph",M,32,1929,1980,51,51-60
2154,"Friesen, Benno",M,32,1929,1980,51,51-60
2155,"Howie, J. Robert",M,32,1929,1980,51,51-60
2156,"Korchinski, Stanley James",M,32,1929,1980,51,51-60
2157,"Lalonde, Marc",M,32,1929,1980,51,51-60
2158,"Ostiguy, Marcel",M,32,1929,1980,51,51-60
2159,"Shields, Jack Wendele",M,32,1929,1980,51,51-60
2160,"Belsher, Ross",M,33,1933,1984,51,51-60
2161,"Crosby, Howard Edward",M,33,1933,1984,51,51-60
2162,"Foster, Maurice Brydon",M,33,1933,1984,51,51-60
2163,"Gervais, Aurèle",M,33,1933,1984,51,51-60
2164,"Hicks, Robert Nelson David",M,33,1933,1984,51,51-60
2165,"Jourdenais, Fernand",M,33,1933,1984,51,51-60
2166,"Lanthier, Claude",M,33,1933,1984,51,51-60
2167,"Mantha, Moe",M,33,1933,1984,51,51-60
2168,"Penner, B. Keith",M,33,1933,1984,51,51-60
2169,"Tupper, William",M,33,1933,1984,51,51-60
2170,"Weiner, Gérard (Gerry)",M,33,1933,1984,51,51-60
2171,"Althouse, Victor Fredrich (Vic)",M,34,1937,1988,51,51-60
2172,"Beatty, Henry Perrin",M,34,1937,1988,51,51-60
2173,"Karpoff, James Capsey (Jim)",M,34,1937,1988,51,51-60
2174,"Landry, Monique",F,34,1937,1988,51,51-60
2175,"Lopez, Ricardo",M,34,1937,1988,51,51-60
2176,"Malone, Arnold John",M,34,1937,1988,51,51-60
2177,"McDougall, Barbara Jean",F,34,1937,1988,51,51-60
2178,"Plourde, André",M,34,1937,1988,51,51-60
2179,"Rodriguez, John R.",M,34,1937,1988,51,51-60
2180,"Wilson, Michael Holcombe",M,34,1937,1988,51,51-60
2181,"Abbott, Jim",M,35,1942,1993,51,51-60
2182,"Bonin, Raymond",M,35,1942,1993,51,51-60
2183,"Brushett, Dianne",F,35,1942,1993,51,51-60
2184,"Cummins, John Martin",M,35,1942,1993,51,51-60
2185,"de Jong, Simon Leendert",M,35,1942,1993,51,51-60
2186,"de Savoye, Pierre",M,35,1942,1993,51,51-60
2187,"Gagliano, Alfonso",M,35,1942,1993,51,51-60
2188,"Gilmour, William (Bill) Douglas",M,35,1942,1993,51,51-60
2189,"Godfrey, John Ferguson",M,35,1942,1993,51,51-60
2190,"Manning, Ernest Preston",M,35,1942,1993,51,51-60
2191,"McClelland, Ian G.",M,35,1942,1993,51,51-60
2192,"Penson, Charles Frederick (Charlie)",M,35,1942,1993,51,51-60
2193,"Riis, Nelson Andrew",M,35,1942,1993,51,51-60
2194,"Steckle, Paul Daniel",M,35,1942,1993,51,51-60
2195,"Chatters, David Cameron",M,36,1946,1997,51,51-60
2196,"Chrétien, Jean-Guy",M,36,1946,1997,51,51-60
2197,"Collenette, David Michael",M,36,1946,1997,51,51-60
2198,"DeVillers, Paul",M,36,1946,1997,51,51-60
2199,"Forseth, Paul Eugene",M,36,1946,1997,51,51-60
2200,"Gouk, James William (Jim)",M,36,1946,1997,51,51-60
2201,"Lebel, Ghislain",M,36,1946,1997,51,51-60
2202,"MacAulay, Lawrence",M,36,1946,1997,51,51-60
2203,"Milliken, Peter Andrew Stewart",M,36,1946,1997,51,51-60
2204,"Mills, Dennis Joseph",M,36,1946,1997,51,51-60
2205,"Nystrom, Lorne Edmund",M,36,1946,1997,51,51-60
2206,"Parrish, Carolyn",F,36,1946,1997,51,51-60
2207,"Proulx, Marcel",M,36,1946,1997,51,51-60
2208,"Shepherd, Alexander James",M,36,1946,1997,51,51-60
2209,"Telegdi, Andrew",M,36,1946,1997,51,51-60
2210,"Ur, Rose-Marie Margaret",F,36,1946,1997,51,51-60
2211,"Ablonczy, Diane",F,37,1949,2000,51,51-60
2212,"Allard, Carole-Marie",F,37,1949,2000,51,51-60
2213,"Bagnell, Larry",M,37,1949,2000,51,51-60
2214,"Bélair, Réginald",M,37,1949,2000,51,51-60
2215,"Boudria, Don",M,37,1949,2000,51,51-60
2216,"Bourgeois, Diane",F,37,1949,2000,51,51-60
2217,"Bradshaw, Claudette",F,37,1949,2000,51,51-60
2218,"Discepola, Nunzio (Nick)",M,37,1949,2000,51,51-60
2219,"Easter, Wayne",M,37,1949,2000,51,51-60
2220,"Frulla, Liza",F,37,1949,2000,51,51-60
2221,"Goodale, Ralph",M,37,1949,2000,51,51-60
2222,"Malhi, Gurbax Singh",M,37,1949,2000,51,51-60
2223,"Meredith, Valerie (Val)",F,37,1949,2000,51,51-60
2224,"Paradis, Denis",M,37,1949,2000,51,51-60
2225,"Peric, Janko",M,37,1949,2000,51,51-60
2226,"Roy, Jean-Yves",M,37,1949,2000,51,51-60
2227,"Brunelle, Paule",F,38,1953,2004,51,51-60
2228,"Bulte, Sarmite D.",F,38,1953,2004,51,51-60
2229,"Clavet, Roger",M,38,1953,2004,51,51-60
2230,"Crête, Paul",M,38,1953,2004,51,51-60
2231,"Davies, Libby",F,38,1953,2004,51,51-60
2232,"Guarnieri, Albina",F,38,1953,2004,51,51-60
2233,"Guimond, Michel",M,38,1953,2004,51,51-60
2234,"Kadis, Susan",F,38,1953,2004,51,51-60
2235,"Kamp, Randy",M,38,1953,2004,51,51-60
2236,"Keddy, Gerald",M,38,1953,2004,51,51-60
2237,"Merrifield, Rob",M,38,1953,2004,51,51-60
2238,"Redman, Karen",F,38,1953,2004,51,51-60
2239,"Yelich, Lynne",F,37,1953,2000,47,41-50
2240,"Bélanger, Mauril",M,39,1955,2006,51,51-60
2241,"Cuzner, Rodger",M,39,1955,2006,51,51-60
2242,"Dion, Stéphane",M,39,1955,2006,51,51-60
2243,"Fast, Edward",M,39,1955,2006,51,51-60
2244,"Godin, Yvon",M,39,1955,2006,51,51-60
2245,"Karygiannis, Jim",M,39,1955,2006,51,51-60
2246,"Martin, Pat",M,39,1955,2006,51,51-60
2247,"Paquette, Pierre A.",M,39,1955,2006,51,51-60
2248,"Preston, Joe",M,39,1955,2006,51,51-60
2249,"Scott, Andy",M,39,1955,2006,51,51-60
2250,"Siksay, Bill",M,39,1955,2006,51,51-60
2251,"Tweed, Mervin C.",M,39,1955,2006,51,51-60
2252,"Van Kesteren, Dave",M,39,1955,2006,51,51-60
2253,"Vellacott, Maurice",M,38,1955,2004,49,41-50
2254,"Anderson, David",M,40,1957,2008,51,51-60
2255,"Anderson, David",M,40,1957,2008,51,51-60
2256,"Chow, Olivia",F,40,1957,2008,51,51-60
2257,"Finley, Diane",F,40,1957,2008,51,51-60
2258,"Laframboise, Mario",M,40,1957,2008,51,51-60
2259,"Lunn, Gary",M,40,1957,2008,51,51-60
2260,"McLeod, Cathy",F,40,1957,2008,51,51-60
2261,"Scarpaleggia, Francis",M,40,1957,2008,51,51-60
2262,"Stanton, Bruce",M,40,1957,2008,51,51-60
2263,"Strahl, Charles (Chuck)",M,40,1957,2008,51,51-60
2264,"Sweet, David",M,40,1957,2008,51,51-60
2265,"Allen, Mike",M,41,1960,2011,51,51-60
2266,"Aubin, Robert",M,41,1960,2011,51,51-60
2267,"Boivin, Françoise",F,41,1960,2011,51,51-60
2268,"Brown, Gordon",M,41,1960,2011,51,51-60
2269,"Eyking, Mark",M,41,1960,2011,51,51-60
2270,"Falk, Ted",M,41,1960,2011,51,51-60
2271,"Gallant, Cheryl",F,41,1960,2011,51,51-60
2272,"Gosal, Bal",M,41,1960,2011,51,51-60
2273,"McGuinty, David",M,41,1960,2011,51,51-60
2274,"Wrzesnewskyj, Borys",M,40,1960,2008,48,41-50
2275,"Badawey, Vance",M,42,1964,2015,51,51-60
2276,"Brassard, John",M,42,1964,2015,51,51-60
2277,"Deltell, Gérard",M,42,1964,2015,51,51-60
2278,"Gourde, Jacques",M,42,1964,2015,51,51-60
2279,"Lemieux, Denis",M,42,1964,2015,51,51-60
2280,"Ludwig, Karen",F,42,1964,2015,51,51-60
2281,"Maloney, James",M,42,1964,2015,51,51-60
2282,"Manly, Paul",M,42,1964,2015,51,51-60
2283,"McCauley, Kelly",M,42,1964,2015,51,51-60
2284,"Reid, Scott",M,42,1964,2015,51,51-60
2285,"Sheehan, Terry",M,42,1964,2015,51,51-60
2286,"Sohi, Amarjeet",M,42,1964,2015,51,51-60
2287,"Weston, Rodney",M,41,1964,2011,47,41-50
2288,"Yurdiga, David",M,41,1964,2011,47,41-50
2289,"Alleslev, Leona",F,43,1968,2019,51,51-60
2290,"Blaney, Rachel",F,43,1968,2019,51,51-60
2291,"Calkins, Blaine",M,43,1968,2019,51,51-60
2292,"Freeland, Chrystia",F,43,1968,2019,51,51-60
2293,"Jones, Yvonne",F,43,1968,2019,51,51-60
2294,"Masse, Brian",M,43,1968,2019,51,51-60
2295,"Perron, Yves",M,43,1968,2019,51,51-60
2296,"Sidhu, Sonia",F,43,1968,2019,51,51-60
2297,"Zimmer, Bob",M,42,1968,2015,47,41-50
2298,"Zimmer, Bob",M,43,1968,2019,51,51-60
2299,"Michaud, Kristina",F,43,1993,2019,26,18-30
2300,"Oberle, Frank",M,29,1932,1972,40,31-40
2301,"Cousineau, René",M,32,1930,1980,50,41-50
2302,"Clarke, William Hillary (Bill)",M,29,1933,1972,39,31-40
2303,"Faulkner, James Hugh",M,29,1933,1972,39,31-40
2304,"Foster, Maurice Brydon",M,29,1933,1972,39,31-40
2305,"Guay, Raynald Joseph Albert",M,29,1933,1972,39,31-40
2306,"Jerome, James Alexander",M,29,1933,1972,39,31-40
2307,"Penner, B. Keith",M,29,1933,1972,39,31-40
2308,"Reilly, Peter",M,29,1933,1972,39,31-40
2309,"Schumacher, Stanley Stanford",M,29,1933,1972,39,31-40
2310,"Blackburn, Derek Nigel Ernest",M,29,1934,1972,38,31-40
2311,"Chrétien, Joseph Jacques Jean",M,29,1934,1972,38,31-40
2312,"Higson, Kenneth James",M,29,1934,1972,38,31-40
2313,"Watson, Ian",M,29,1934,1972,38,31-40
2314,"Firth, Walter (Wally)",M,29,1935,1972,37,31-40
2315,"Matte, René",M,29,1935,1972,37,31-40
2316,"Mazankowski, Donald Frank",M,29,1935,1972,37,31-40
2317,"Wise, John",M,29,1935,1972,37,31-40
2318,"Bégin, Monique",F,29,1936,1972,36,31-40
2319,"Blaker, Roderick",M,29,1936,1972,36,31-40
2320,"Broadbent, John Edward",M,29,1936,1972,36,31-40
2321,"Campbell, John",M,29,1936,1972,36,31-40
2322,"Grier, Terrence Wyly",M,29,1936,1972,36,31-40
2323,"Guilbault, Jacques",M,29,1936,1972,36,31-40
2324,"MacDonald, David Samuel Horne",M,29,1936,1972,36,31-40
2325,"MacKay, Elmer MacIntosh",M,29,1936,1972,36,31-40
2326,"Roy, Marcel-Claude",M,29,1936,1972,36,31-40
2327,"Beatty, Henry Perrin",M,29,1937,1972,35,31-40
2328,"Caron, Yves",M,29,1937,1972,35,31-40
2329,"Hueglin, Joseph Fred",M,29,1937,1972,35,31-40
2330,"Reid, John Mercer",M,29,1937,1972,35,31-40
2331,"Rodriguez, John R.",M,29,1937,1972,35,31-40
2332,"Rooney, Richard David (Dave)",M,29,1937,1972,35,31-40
2333,"Yewchuk, Paul",M,29,1937,1972,35,31-40
2334,"Demers, Yves",M,29,1938,1972,34,31-40
2335,"Haliburton, Charles E.",M,29,1938,1972,34,31-40
2336,"Stewart, William Douglas",M,29,1938,1972,34,31-40
2337,"Boisvert, Jean-Marie",M,29,1939,1972,33,31-40
2338,"Clark, Charles Joseph",M,29,1939,1972,33,31-40
2339,"Epp, Arthur Jacob (Jake)",M,29,1939,1972,33,31-40
2340,"Fleming, James Sydney Clark",M,29,1939,1972,33,31-40
2341,"Lundrigan, John Howard",M,29,1939,1972,33,31-40
2342,"Ouellet, André",M,29,1939,1972,33,31-40
2343,"Pelletier, Irénée",M,29,1939,1972,33,31-40
2344,"Andre, Harvie",M,29,1940,1972,32,31-40
2345,"Blais, Jean-Jacques",M,29,1940,1972,32,31-40
2346,"Caouette, Gilles",M,29,1940,1972,32,31-40
2347,"Baker, Walter David",M,32,1930,1980,50,41-50
2348,"Blenkarn, Donald Alex",M,32,1930,1980,50,41-50
2349,"Caccia, Charles L.",M,32,1930,1980,50,41-50
2350,"Domm, William Henry (Bill)",M,32,1930,1980,50,41-50
2351,"Hopkins, Leonard Donald",M,32,1930,1980,50,41-50
2352,"Jarvis, William Herbert",M,32,1930,1980,50,41-50
2353,"Parker, Sidney James",M,32,1930,1980,50,41-50
2354,"Bernier, Gilles",M,33,1934,1984,50,41-50
2355,"Bernier, Gilles",M,33,1934,1984,50,41-50
2356,"Blackburn, Derek Nigel Ernest",M,33,1934,1984,50,41-50
2357,"Cardiff, Murray",M,33,1934,1984,50,41-50
2358,"Chrétien, Joseph Jacques Jean",M,33,1934,1984,50,41-50
2359,"Desrosiers, Édouard",M,33,1934,1984,50,41-50
2360,"Gottselig, William (Bill)",M,33,1934,1984,50,41-50
2361,"Hawkes, Frederick James (Jim)",M,33,1934,1984,50,41-50
2362,"Hnatyshyn, Ramon John",M,33,1934,1984,50,41-50
2363,"James, Kenneth Albert",M,33,1934,1984,50,41-50
2364,"Bouchard, Lucien",M,34,1938,1988,50,41-50
2365,"Browes, Pauline",F,34,1938,1988,50,41-50
2366,"Clifford, Terrence (Terry)",M,34,1938,1988,50,41-50
2367,"Corbett, Robert Alfred",M,34,1938,1988,50,41-50
2368,"Harvard, John",M,34,1938,1988,50,41-50
2369,"Hockin, Thomas",M,34,1938,1988,50,41-50
2370,"Langlois, Charles A.",M,34,1938,1988,50,41-50
2371,"Lewis, Douglas Grinslade",M,34,1938,1988,50,41-50
2372,"Malépart, Jean-Claude",M,34,1938,1988,50,41-50
2373,"Martin, Paul Edgar Philippe",M,34,1938,1988,50,41-50
2374,"Mifflin, Fred J.",M,34,1938,1988,50,41-50
2375,"Monteith, Ken",M,34,1938,1988,50,41-50
2376,"Phinney, Elizabeth  (Beth)",F,34,1938,1988,50,41-50
2377,"Schneider, Larry",M,34,1938,1988,50,41-50
2378,"Scott, Geoffrey Douglas",M,34,1938,1988,50,41-50
2379,"Bethel, Judith Claire (Judy)",F,35,1943,1993,50,41-50
2380,"Bryden, John H.",M,35,1943,1993,50,41-50
2381,"Hanger, Art",M,35,1943,1993,50,41-50
2382,"Lefebvre, Réjean",M,35,1943,1993,50,41-50
2383,"Marleau, Diane",F,35,1943,1993,50,41-50
2384,"Patry, Bernard",M,35,1943,1993,50,41-50
2385,"Plamondon, Louis",M,35,1943,1993,50,41-50
2386,"Vanclief, Lyle",M,35,1943,1993,50,41-50
2387,"Axworthy, Chris",M,36,1947,1997,50,41-50
2388,"Dubé, Antoine",M,36,1947,1997,50,41-50
2389,"Duceppe, Gilles",M,36,1947,1997,50,41-50
2390,"Hilstrom, Howard E.",M,36,1947,1997,50,41-50
2391,"Longfield, Judi",F,36,1947,1997,50,41-50
2392,"Mahoney, Steve",M,36,1947,1997,50,41-50
2393,"Mark, Inky",M,36,1947,1997,50,41-50
2394,"Matthews, Bill",M,36,1947,1997,50,41-50
2395,"Picard, Pauline",F,36,1947,1997,50,41-50
2396,"Rock, Allan",M,36,1947,1997,50,41-50
2397,"Saada, Jacques",M,36,1947,1997,50,41-50
2398,"Thompson, Gregory Francis",M,36,1947,1997,50,41-50
2399,"Volpe, Giuseppe (Joseph)",M,36,1947,1997,50,41-50
2400,"Asselin, Gérard",M,37,1950,2000,50,41-50
2401,"Bennett, Carolyn",F,37,1950,2000,50,41-50
2402,"Benoit, Leon Earl",M,37,1950,2000,50,41-50
2403,"Borotsik, Rick",M,37,1950,2000,50,41-50
2404,"Cardin, Serge",M,37,1950,2000,50,41-50
2405,"Day, Stockwell Burt",M,37,1950,2000,50,41-50
2406,"Fontana, Joseph Frank (Joe)",M,37,1950,2000,50,41-50
2407,"Gauthier, Michel",M,37,1950,2000,50,41-50
2408,"Hinton, Betty",F,37,1950,2000,50,41-50
2409,"Lill, Wendy",F,37,1950,2000,50,41-50
2410,"Manley, John Paul",M,37,1950,2000,50,41-50
2411,"McCallum, John",M,37,1950,2000,50,41-50
2412,"McLellan, A. Anne",F,37,1950,2000,50,41-50
2413,"Obhrai, Deepak",M,37,1950,2000,50,41-50
2414,"Scherrer, Hélène C.",F,37,1950,2000,50,41-50
2415,"St. Denis, Brent",M,37,1950,2000,50,41-50
2416,"Wappel, Thomas (Tom) William",M,36,1950,1997,47,41-50
2417,"Bakopanos, Eleni",F,38,1954,2004,50,41-50
2418,"Blais, Raynald",M,38,1954,2004,50,41-50
2419,"Christopherson, David",M,38,1954,2004,50,41-50
2420,"Lavallée, Carole",F,38,1954,2004,50,41-50
2421,"Pallister, Brian William",M,38,1954,2004,50,41-50
2422,"Simard, Christian",M,38,1954,2004,50,41-50
2423,"Temelkovski, Lui",M,38,1954,2004,50,41-50
2424,"Lapierre, Jean-C.",M,39,1956,2006,50,41-50
2425,"Miller, Larry",M,39,1956,2006,50,41-50
2426,"Prentice, Jim",M,39,1956,2006,50,41-50
2427,"Stoffer, Peter",M,39,1956,2006,50,41-50
2428,"Vincent, Robert",M,38,1956,2004,48,41-50
2429,"Zed, Paul",M,38,1956,2004,48,41-50
2430,"Dechert, Bob",M,40,1958,2008,50,41-50
2431,"Goodyear, Gary",M,40,1958,2008,50,41-50
2432,"Grewal, Nina",F,40,1958,2008,50,41-50
2433,"Hughes, Carol",F,40,1958,2008,50,41-50
2434,"Shory, Devinder",M,40,1958,2008,50,41-50
2435,"Sorenson, Kevin",M,40,1958,2008,50,41-50
2436,"Block, Kelly",F,41,1961,2011,50,41-50
2437,"Cannan, Ronald",M,41,1961,2011,50,41-50
2438,"Clement, Tony",M,41,1961,2011,50,41-50
2439,"Opitz, Ted",M,41,1961,2011,50,41-50
2440,"Rousseau, Jean",M,41,1961,2011,50,41-50
2441,"Saganash, Romeo",M,41,1961,2011,50,41-50
2442,"Allison, Dean",M,42,1965,2015,50,41-50
2443,"Bezan, James",M,42,1965,2015,50,41-50
2444,"Blaney, Steven",M,42,1965,2015,50,41-50
2445,"Duclos, Jean-Yves",M,42,1965,2015,50,41-50
2446,"Fisher, Darren",M,42,1965,2015,50,41-50
2447,"Godin, Joël",M,42,1965,2015,50,41-50
2448,"Iacono, Angelo",M,42,1965,2015,50,41-50
2449,"Alghabra, Omar",M,43,1969,2019,50,41-50
2450,"d'Entremont, Chris",M,43,1969,2019,50,41-50
2451,"Fergus, Greg",M,43,1969,2019,50,41-50
2452,"Fortier, Mona",F,43,1969,2019,50,41-50
2453,"Ien, Marci",F,43,1969,2019,50,41-50
2454,"Johns, Gord",M,43,1969,2019,50,41-50
2455,"Kusie, Stephanie",F,43,1969,2019,50,41-50
2456,"Lake, Mike",M,43,1969,2019,50,41-50
2457,"Louis, Tim",M,43,1969,2019,50,41-50
2458,"Ng, Mary",F,43,1969,2019,50,41-50
2459,"Paul-Hus, Pierre",M,43,1969,2019,50,41-50
2460,"Petitpas Taylor, Ginette",F,43,1969,2019,50,41-50
2461,"Sarai, Randeep",M,43,1969,2019,50,41-50
2462,"Simms, Scott",M,43,1969,2019,50,41-50
2463,"Dick, Paul Wyatt",M,29,1940,1972,32,31-40
2464,"Jelinek, Otto John",M,29,1940,1972,32,31-40
2465,"O'Connor, Terrance Patrick (Terry)",M,29,1940,1972,32,31-40
2466,"Rowland, Douglas Charles",M,29,1940,1972,32,31-40
2467,"Atkey, Ronald George",M,29,1942,1972,30,18-30
2468,"Dupont, Raymond",M,29,1942,1972,30,18-30
2469,"Reynolds, John Douglas",M,29,1942,1972,30,18-30
2470,"Fortin, André-Gilles",M,29,1943,1972,29,18-30
2471,"Murta, Jack Burnett",M,29,1943,1972,29,18-30
2472,"Symes, Reginald Cyril",M,29,1943,1972,29,18-30
2473,"Breau, Herb",M,29,1944,1972,28,18-30
2474,"Olivier, Joseph Mario Jacques",M,29,1944,1972,28,18-30
2475,"Nystrom, Lorne Edmund",M,29,1946,1972,26,18-30
2476,"Knight, William George",M,29,1947,1972,25,18-30
2477,"Schellenberger, Stanley Kenneth",M,29,1948,1972,24,18-30
2478,"O'Sullivan, Sean Patrick",M,29,1952,1972,20,18-30
2479,"Diefenbaker, John George",M,30,1895,1974,79,71+
2480,"Rynard, Philip Bernard",M,30,1897,1974,77,71+
2481,"Michener, Daniel Roland",M,30,1900,1974,74,71+
2482,"Douglas, Thomas Clement (Tommy)",M,30,1904,1974,70,61-70
2483,"MacDonald, Flora Isabel",F,30,1904,1974,70,61-70
2484,"MacInnis, Winona Grace",F,30,1905,1974,69,61-70
2485,"Railton, Samuel Victor",M,30,1906,1974,68,61-70
2486,"Baldwin, Gerald William",M,30,1907,1974,67,61-70
2487,"Crosbie, John Carnell",M,32,1931,1980,49,41-50
2488,"Dionne, Marcel",M,32,1931,1980,49,41-50
2489,"Fraser, John Allen",M,32,1931,1980,49,41-50
2490,"Gray, Herbert Eser (Herb)",M,32,1931,1980,49,41-50
2491,"MacGuigan, Mark R.",M,32,1931,1980,49,41-50
2492,"Masters, John Gerald (Jack)",M,32,1931,1980,49,41-50
2493,"Munro, John Carr",M,32,1931,1980,49,41-50
2494,"Nowlan, John Patrick (Pat)",M,32,1931,1980,49,41-50
2495,"Crofton, Patrick Dermott",M,33,1935,1984,49,41-50
2496,"Garneau, Raymond",M,33,1935,1984,49,41-50
2497,"Henderson, George Roland",M,33,1935,1984,49,41-50
2498,"Jardine, W.R. (Bud)",M,33,1935,1984,49,41-50
2499,"Mazankowski, Donald Frank",M,33,1935,1984,49,41-50
2500,"Redway, Alan",M,33,1935,1984,49,41-50
2501,"Sparrow, Barbara Jane (Bobbie)",F,33,1935,1984,49,41-50
2502,"Vézina, Monique",F,33,1935,1984,49,41-50
2503,"Axworthy, Lloyd",M,34,1939,1988,49,41-50
2504,"Catterall, Marlene",F,34,1939,1988,49,41-50
2505,"Clark, Charles Joseph",M,34,1939,1988,49,41-50
2506,"Côté, Yvon",M,34,1939,1988,49,41-50
2507,"Couture, Clément",M,34,1939,1988,49,41-50
2508,"Deblois, Charles",M,34,1939,1988,49,41-50
2509,"Epp, Arthur Jacob (Jake)",M,34,1939,1988,49,41-50
2510,"Horning, Edward Allan",M,34,1939,1988,49,41-50
2511,"Kristiansen, Lyle Stuart",M,34,1939,1988,49,41-50
2512,"Mulroney, Martin Brian",M,34,1939,1988,49,41-50
2513,"Ouellet, André",M,34,1939,1988,49,41-50
2514,"Proud, George Albert",M,34,1939,1988,49,41-50
2515,"Simmons, Roger",M,34,1939,1988,49,41-50
2516,"Beaumier, Colleen",F,35,1944,1993,49,41-50
2517,"Caron, André",M,35,1944,1993,49,41-50
2518,"Culbert, Harold William",M,35,1944,1993,49,41-50
2519,"Cullen, Roy",M,35,1944,1993,49,41-50
2520,"Kilger, Robert (Bob)",M,35,1944,1993,49,41-50
2521,"Marchand, Jean-Paul",M,35,1944,1993,49,41-50
2522,"McGuire, Joseph Blair (Joe)",M,35,1944,1993,49,41-50
2523,"Rocheleau, Yves",M,35,1944,1993,49,41-50
2524,"Alcock, Reginald B.",M,36,1948,1997,49,41-50
2525,"Assadourian, Sarkis",M,36,1948,1997,49,41-50
2526,"Cadman, Chuck",M,36,1948,1997,49,41-50
2527,"Casson, Rick",M,36,1948,1997,49,41-50
2528,"Cohen, Elizabeth Shaughnessy",F,36,1948,1997,49,41-50
2529,"Duncan, John",M,36,1948,1997,49,41-50
2530,"Gagnon, Christiane",F,36,1948,1997,49,41-50
2531,"Gallaway, Roger John",M,36,1948,1997,49,41-50
2532,"Gruending, Dennis",M,36,1948,1997,49,41-50
2533,"Hayes, Sharon Ruth",F,36,1948,1997,49,41-50
2534,"Lee, Derek Vincent",M,36,1948,1997,49,41-50
2535,"McKay, John",M,36,1948,1997,49,41-50
2536,"Minna, Maria",F,36,1948,1997,49,41-50
2537,"O'Brien, Pat",M,36,1948,1997,49,41-50
2538,"Power, Charles J. (Charlie)",M,36,1948,1997,49,41-50
2539,"Szabo, Paul John Mark",M,36,1948,1997,49,41-50
2540,"White, Randy A.",M,35,1948,1993,45,41-50
2541,"Bachand, Claude",M,37,1951,2000,49,41-50
2542,"Blaikie, William Alexander (Bill)",M,37,1951,2000,49,41-50
2543,"Blondin-Andrew, Ethel Dorothy",F,37,1951,2000,49,41-50
2544,"Calder, Murray",M,37,1951,2000,49,41-50
2545,"Cannis, John",M,37,1951,2000,49,41-50
2546,"Desrochers, Odina",M,37,1951,2000,49,41-50
2547,"Jennings, Marlene",F,37,1951,2000,49,41-50
2548,"Lunney, James",M,37,1951,2000,49,41-50
2549,"Murphy, Shawn",M,37,1951,2000,49,41-50
2550,"Myers, Lynn",M,37,1951,2000,49,41-50
2551,"O'Brien, Lawrence D.",M,37,1951,2000,49,41-50
2552,"Pettigrew, Pierre Stewart",M,37,1951,2000,49,41-50
2553,"Ritz, Gerry",M,37,1951,2000,49,41-50
2554,"Serré, Benoît",M,37,1951,2000,49,41-50
2555,"Wasylycia-Leis, Judy",F,36,1951,1997,46,41-50
2556,"Bélanger, Mauril",M,38,1955,2004,49,41-50
2557,"Carr, Gary",M,38,1955,2004,49,41-50
2558,"Cuzner, Rodger",M,38,1955,2004,49,41-50
2559,"Desjarlais, Bev",F,38,1955,2004,49,41-50
2560,"Dion, Stéphane",M,38,1955,2004,49,41-50
2561,"Godin, Yvon",M,38,1955,2004,49,41-50
2562,"Karygiannis, Jim",M,38,1955,2004,49,41-50
2563,"Martin, Pat",M,38,1955,2004,49,41-50
2564,"Paquette, Pierre A.",M,38,1955,2004,49,41-50
2565,"Preston, Joe",M,38,1955,2004,49,41-50
2566,"Scott, Andy",M,38,1955,2004,49,41-50
2567,"Siksay, Bill",M,38,1955,2004,49,41-50
2568,"Tweed, Mervin C.",M,38,1955,2004,49,41-50
2569,"Anderson, David",M,39,1957,2006,49,41-50
2570,"Anderson, David",M,39,1957,2006,49,41-50
2571,"Chow, Olivia",F,39,1957,2006,49,41-50
2572,"Finley, Diane",F,39,1957,2006,49,41-50
2573,"Karetak-Lindell, Nancy",F,39,1957,2006,49,41-50
2574,"Laframboise, Mario",M,39,1957,2006,49,41-50
2575,"Lunn, Gary",M,39,1957,2006,49,41-50
2576,"Scarpaleggia, Francis",M,39,1957,2006,49,41-50
2577,"Stanton, Bruce",M,39,1957,2006,49,41-50
2578,"Strahl, Charles (Chuck)",M,39,1957,2006,49,41-50
2579,"Sweet, David",M,39,1957,2006,49,41-50
2580,"Valley, Roger",M,39,1957,2006,49,41-50
2581,"André, Guy",M,40,1959,2008,49,41-50
2582,"Deschamps, Johanne",F,40,1959,2008,49,41-50
2583,"Guay, Monique",F,40,1959,2008,49,41-50
2584,"Hall Findlay, Martha",F,40,1959,2008,49,41-50
2585,"Harper, Stephen",M,40,1959,2008,49,41-50
2586,"Nadeau, Richard",M,40,1959,2008,49,41-50
2587,"Regan, Geoff",M,40,1959,2008,49,41-50
2588,"Shea, Gail",F,40,1959,2008,49,41-50
2589,"Angus, Charlie",M,41,1962,2011,49,41-50
2590,"Ayala, Paulina",F,41,1962,2011,49,41-50
2591,"Carrie, Colin",M,41,1962,2011,49,41-50
2592,"Cash, Andrew",M,41,1962,2011,49,41-50
2593,"Groguhé, Sadia",F,41,1962,2011,49,41-50
2594,"Julian, Peter",M,41,1962,2011,49,41-50
2595,"Lamoureux, Kevin",M,41,1962,2011,49,41-50
2596,"Pacetti, Massimo",M,41,1962,2011,49,41-50
2597,"Scott, Craig",M,41,1962,2011,49,41-50
2598,"Toet, Lawrence",M,41,1962,2011,49,41-50
2599,"Aboultaif, Ziad",M,42,1966,2015,49,41-50
2600,"Breton, Pierre",M,42,1966,2015,49,41-50
2601,"Donnelly, Fin",M,42,1966,2015,49,41-50
2602,"Duncan, Kirsty",F,42,1966,2015,49,41-50
2603,"Fillmore, Andy",M,42,1966,2015,49,41-50
2604,"Fonseca, Peter",M,42,1966,2015,49,41-50
2605,"Hajdu, Patricia",F,42,1966,2015,49,41-50
2606,"Lauzon, Stéphane",M,42,1966,2015,49,41-50
2607,"MacKinnon, Steven",M,42,1966,2015,49,41-50
2608,"Malcolmson, Sheila",F,42,1966,2015,49,41-50
2609,"Spengemann, Sven",M,42,1966,2015,49,41-50
2610,"Stewart, Kennedy",M,42,1966,2015,49,41-50
2611,"Bibeau, Marie-Claude",F,43,1970,2019,49,41-50
2612,"Champagne, François-Philippe",M,43,1970,2019,49,41-50
2613,"Ehsassi, Ali",M,43,1970,2019,49,41-50
2614,"Gazan, Leah",F,43,1970,2019,49,41-50
2615,"Guilbeault, Steven",M,43,1970,2019,49,41-50
2616,"Hussen, Ahmed",M,43,1970,2019,49,41-50
2617,"Kelloway, Mike",M,43,1970,2019,49,41-50
2618,"Sajjan, Harjit Singh",M,43,1970,2019,49,41-50
2619,"Seeback, Kyle",M,43,1970,2019,49,41-50
2620,"Shin, Nelly",F,43,1970,2019,49,41-50
2621,"Williamson, John",M,43,1970,2019,49,41-50
2622,"Zahid, Salma",F,42,1970,2015,45,41-50
2623,"Zahid, Salma",F,43,1970,2019,49,41-50
2624,"Brewin, Francis Andrew",M,30,1907,1974,67,61-70
2625,"Dionne, Charles-Eugène",M,30,1908,1974,66,61-70
2626,"Knowles, Stanley Howard",M,30,1908,1974,66,61-70
2627,"Knowles, William David",M,30,1908,1974,66,61-70
2628,"Tétrault, Oza",M,30,1908,1974,66,61-70
2629,"Hales, Alfred Dryden",M,30,1909,1974,65,61-70
2630,"Barnett, Thomas Speakman",M,30,1909,1974,65,61-70
2631,"Duquet, Gérard",M,30,1909,1974,65,61-70
2632,"Lewis, David",M,30,1909,1974,65,61-70
2633,"Mather, Barry",M,30,1909,1974,65,61-70
2634,"Hees, George Harris",M,30,1910,1974,64,61-70
2635,"Darling, Stan",M,30,1911,1974,63,61-70
2636,"Gleave, Alfred Pullen",M,30,1911,1974,63,61-70
2637,"Patterson, Alexander Bell",M,30,1911,1974,63,61-70
2638,"Sharp, Mitchell William",M,30,1911,1974,63,61-70
2639,"Walker, James Edgar",M,30,1911,1974,63,61-70
2640,"Alkenbrack, Almonte Douglas",M,30,1912,1974,62,61-70
2641,"Blouin, Gustave",M,30,1912,1974,62,61-70
2642,"Drury, Charles Mills (Bud)",M,30,1912,1974,62,61-70
2643,"Hamilton, Francis Alvin George",M,30,1912,1974,62,61-70
2644,"Smith, Walter Bernard",M,30,1912,1974,62,61-70
2645,"Thomas, J. Antonio",M,30,1912,1974,62,61-70
2646,"Clermont, Gaston",M,30,1913,1974,61,61-70
2647,"Latulippe, Henry P.",M,30,1913,1974,61,61-70
2648,"Gauthier, Charles-Arthur",M,30,1913,1974,61,61-70
2649,"Hymmen, Kieth Reinhardt",M,30,1913,1974,61,61-70
2650,"Lambert, Joseph Adrien Henri",M,30,1913,1974,61,61-70
2651,"Harding, Randolph",M,30,1914,1974,60,51-60
2652,"L'Heureux, Yvon",M,30,1914,1974,60,51-60
2653,"Allmand, William Warren",M,32,1932,1980,48,41-50
2654,"Beauchamp-Niquet, Suzanne",F,32,1932,1980,48,41-50
2655,"Manly, James Douglas",M,32,1932,1980,48,41-50
2656,"McGrath, James Aloysius",M,32,1932,1980,48,41-50
2657,"Oberle, Frank",M,32,1932,1980,48,41-50
2658,"Blais-Grenier, Suzanne",F,33,1936,1984,48,41-50
2659,"Broadbent, John Edward",M,33,1936,1984,48,41-50
2660,"Clark, Walter Leland Rutherford (Lee)",M,33,1936,1984,48,41-50
2661,"Crombie, David Edward",M,33,1936,1984,48,41-50
2662,"Edwards, James (Jim) Stewart",M,33,1936,1984,48,41-50
2663,"Guilbault, Jacques",M,33,1936,1984,48,41-50
2664,"Johnston, Donald James",M,33,1936,1984,48,41-50
2665,"Joncas, Jean-Luc",M,33,1936,1984,48,41-50
2666,"Kaplan, Robert Phillip",M,33,1936,1984,48,41-50
2667,"MacKay, Elmer MacIntosh",M,33,1936,1984,48,41-50
2668,"Masse, Marcel",M,33,1936,1984,48,41-50
2669,"Mayer, Charles James",M,33,1936,1984,48,41-50
2670,"McLaughlin, Audrey Marlene",F,33,1936,1984,48,41-50
2671,"McLean, Walter Franklin",M,33,1936,1984,48,41-50
2672,"Pennock, Robert",M,33,1936,1984,48,41-50
2673,"Reimer, John Henry",M,33,1936,1984,48,41-50
2674,"Roman, Anthony (Tony)",M,33,1936,1984,48,41-50
2675,"Tardif, Monique Bernatchez",F,33,1936,1984,48,41-50
2676,"Andre, Harvie",M,34,1940,1988,48,41-50
2677,"Assad, Mark Joseph",M,34,1940,1988,48,41-50
2678,"Bouchard, Benoît",M,34,1940,1988,48,41-50
2679,"Campbell, Coline M.",F,34,1940,1988,48,41-50
2680,"Collins, Mary",F,34,1940,1988,48,41-50
2681,"Dick, Paul Wyatt",M,34,1940,1988,48,41-50
2682,"Fontaine, Gabriel",M,34,1940,1988,48,41-50
2683,"Jelinek, Otto John",M,34,1940,1988,48,41-50
2684,"MacLellan, Russell Gregoire",M,34,1940,1988,48,41-50
2685,"McDermid, John Horton",M,34,1940,1988,48,41-50
2686,"McKnight, William Hunter (Bill)",M,34,1940,1988,48,41-50
2687,"Pickard, Jerry",M,34,1940,1988,48,41-50
2688,"St-Julien, Guy",M,34,1940,1988,48,41-50
2689,"Wenman, Robert Lloyd",M,34,1940,1988,48,41-50
2690,"Breitkreuz, Garry W.",M,35,1945,1993,48,41-50
2691,"English, John Richard",M,35,1945,1993,48,41-50
2692,"Maloney, John",M,35,1945,1993,48,41-50
2693,"Rideout, George Saunders",M,35,1945,1993,48,41-50
2694,"Robillard, Lucienne",F,35,1945,1993,48,41-50
2695,"Stinson, Darrel",M,35,1945,1993,48,41-50
2696,"Venne, Pierrette",F,35,1945,1993,48,41-50
2697,"Young, Neil",M,34,1945,1988,43,41-50
2698,"Ablonczy, Diane",F,36,1949,1997,48,41-50
2699,"Bélair, Réginald",M,36,1949,1997,48,41-50
2700,"Boudria, Don",M,36,1949,1997,48,41-50
2701,"Bradshaw, Claudette",F,36,1949,1997,48,41-50
2702,"Clouthier, Hector Daniel (Hec)",M,36,1949,1997,48,41-50
2703,"Discepola, Nunzio (Nick)",M,36,1949,1997,48,41-50
2704,"Easter, Wayne",M,36,1949,1997,48,41-50
2705,"Goodale, Ralph",M,36,1949,1997,48,41-50
2706,"Malhi, Gurbax Singh",M,36,1949,1997,48,41-50
2707,"Meredith, Valerie (Val)",F,36,1949,1997,48,41-50
2708,"Paradis, Denis",M,36,1949,1997,48,41-50
2709,"Peric, Janko",M,36,1949,1997,48,41-50
2710,"Barnes, Susan (Sue)",F,37,1952,2000,48,41-50
2711,"Chamberlain, Brenda",F,37,1952,2000,48,41-50
2712,"Copps, Sheila Maureen",F,37,1952,2000,48,41-50
2713,"Dhaliwal, Harbance Singh (Herb)",M,37,1952,2000,48,41-50
2714,"Grey, Deborah C.",F,37,1952,2000,48,41-50
2715,"Hill, Jay D.",M,37,1952,2000,48,41-50
2716,"Jobin, Christian",M,37,1952,2000,48,41-50
2717,"Kraft Sloan, Karen",F,37,1952,2000,48,41-50
2718,"Robinson, Svend Johannes",M,37,1952,2000,48,41-50
2719,"Toews, Vic",M,37,1952,2000,48,41-50
2720,"Wilfert, Bryon",M,36,1952,1997,45,41-50
2721,"Drouin, Claude",M,38,1956,2004,48,41-50
2722,"Lapierre, Jean-C.",M,38,1956,2004,48,41-50
2723,"Miller, Larry",M,38,1956,2004,48,41-50
2724,"Mitchell, Andrew (Andy)",M,38,1956,2004,48,41-50
2725,"Prentice, Jim",M,38,1956,2004,48,41-50
2726,"Stoffer, Peter",M,38,1956,2004,48,41-50
2727,"Goodyear, Gary",M,39,1958,2006,48,41-50
2728,"Grewal, Nina",F,39,1958,2006,48,41-50
2729,"Simard, Raymond",M,39,1958,2006,48,41-50
2730,"Solberg, Monte",M,39,1958,2006,48,41-50
2731,"Sorenson, Kevin",M,39,1958,2006,48,41-50
2732,"Allen, Mike",M,40,1960,2008,48,41-50
2733,"Bevilacqua, Maurizio",M,40,1960,2008,48,41-50
2734,"Brown, Gordon",M,40,1960,2008,48,41-50
2735,"Coady, Siobhan",F,40,1960,2008,48,41-50
2736,"Crombie, Bonnie",F,40,1960,2008,48,41-50
2737,"Dhaliwal, Sukh",M,40,1960,2008,48,41-50
2738,"Eyking, Mark",M,40,1960,2008,48,41-50
2739,"Gallant, Cheryl",F,40,1960,2008,48,41-50
2740,"Kennedy, Gerard",M,40,1960,2008,48,41-50
2741,"Martin, Keith P.",M,40,1960,2008,48,41-50
2742,"McGuinty, David",M,40,1960,2008,48,41-50
2743,"Wrzesnewskyj, Borys",M,39,1960,2006,46,41-50
2744,"Bernier, Maxime",M,41,1963,2011,48,41-50
2745,"Casey, Sean",M,41,1963,2011,48,41-50
2746,"Charlton, Chris",F,41,1963,2011,48,41-50
2747,"Coderre, Denis",M,41,1963,2011,48,41-50
2748,"Davies, Don",M,41,1963,2011,48,41-50
2749,"Devolin, Barry",M,41,1963,2011,48,41-50
2750,"Dewar, Paul",M,41,1963,2011,48,41-50
2751,"Jean, Brian",M,41,1963,2011,48,41-50
2752,"Lemieux, Pierre",M,41,1963,2011,48,41-50
2753,"Nantel, Pierre",M,41,1963,2011,48,41-50
2754,"Van Loan, Peter",M,41,1963,2011,48,41-50
2755,"Wallace, Mike",M,40,1963,2008,45,41-50
2756,"Brison, Scott",M,42,1967,2015,48,41-50
2757,"Chan, Arnold",M,42,1967,2015,48,41-50
2758,"Hoback, Randy",M,42,1967,2015,48,41-50
2759,"LeBlanc, Dominic",M,42,1967,2015,48,41-50
2760,"Saini, Raj",M,42,1967,2015,48,41-50
2761,"Barlow, John",M,43,1971,2019,48,41-50
2762,"Chong, Michael D.",M,43,1971,2019,48,41-50
2763,"Dabrusin, Julie",F,43,1971,2019,48,41-50
2764,"Damoff, Pam",F,43,1971,2019,48,41-50
2765,"Kelly, Pat",M,43,1971,2019,48,41-50
2766,"Lalonde, Marie-France",F,43,1971,2019,48,41-50
2767,"McKenna, Catherine",F,43,1971,2019,48,41-50
2768,"O'Regan, Seamus",M,43,1971,2019,48,41-50
2769,"Qualtrough, Carla",F,43,1971,2019,48,41-50
2770,"Rayes, Alain",M,43,1971,2019,48,41-50
2771,"Sorbara, Francesco",M,43,1971,2019,48,41-50
2772,"Trudeau, Justin",M,43,1971,2019,48,41-50
2773,"Vandenbeld, Anita",F,43,1971,2019,48,41-50
2774,"Vecchio, Karen",F,43,1971,2019,48,41-50
2775,"Virani, Arif",M,42,1971,2015,44,41-50
2776,"Virani, Arif",M,43,1971,2019,48,41-50
2777,"Wilson-Raybould, Jody",F,43,1971,2019,48,41-50
2778,"Gourd, Robert",M,32,1933,1980,47,41-50
2779,"Greenaway, Lorne Everett",M,32,1933,1980,47,41-50
2780,"MacLean, John Angus",M,30,1914,1974,60,51-60
2781,"Stanfield, Robert Lorne",M,30,1914,1974,60,51-60
2782,"Allard, Eudore",M,30,1915,1974,59,51-60
2783,"Madill, John Ellwood",M,30,1915,1974,59,51-60
2784,"Danforth, Harold Warren",M,30,1916,1974,58,51-60
2785,"Davis, John (Jack)",M,30,1916,1974,58,51-60
2786,"Dinsdale, Walter Gilbert",M,30,1916,1974,58,51-60
2787,"Munro, Donald W.",M,30,1916,1974,58,51-60
2788,"Thomas, Charles Humbert",M,30,1916,1974,58,51-60
2789,"Woolliams, Eldon Mattison",M,30,1916,1974,58,51-60
2790,"Caouette, David Réal",M,30,1917,1974,57,51-60
2791,"Hargrave, Herbert Thomas (Bert)",M,30,1917,1974,57,51-60
2792,"McCain, Fred Alward",M,30,1917,1974,57,51-60
2793,"McKinnon, Allan Bruce",M,30,1917,1974,57,51-60
2794,"Nelson, Nels Edwin",M,30,1917,1974,57,51-60
2795,"Boulanger, Prosper",M,30,1918,1974,56,51-60
2796,"Crouse, Lloyd Roseville",M,30,1918,1974,56,51-60
2797,"MacDonald, Daniel Joseph",M,30,1918,1974,56,51-60
2798,"MacInnis, Donald",M,30,1918,1974,56,51-60
2799,"Nesbitt, Wallace Bickford (Wally)",M,30,1918,1974,56,51-60
2800,"Orlikow, David",M,30,1918,1974,56,51-60
2801,"Ritchie, William Gordon",M,30,1918,1974,56,51-60
2802,"Whicher, Ross Mackenzie",M,30,1918,1974,56,51-60
2803,"Lambert, Marcel Joseph Aimé",M,30,1919,1974,55,51-60
2804,"Mitges, Constantine George (Gus)",M,30,1919,1974,55,51-60
2805,"Pelletier, Gérard",M,30,1919,1974,55,51-60
2806,"Towers, Thomas Gordon",M,30,1919,1974,55,51-60
2807,"Trudeau, Pierre Elliott",M,30,1919,1974,55,51-60
2808,"Trudel, Jacques L.",M,30,1919,1974,55,51-60
2809,"Whittaker, George H.",M,30,1919,1974,55,51-60
2810,"Gendron, Rosaire",M,30,1920,1974,54,51-60
2811,"Isabelle, Joseph Gaston",M,30,1920,1974,54,51-60
2812,"Lamoureux, Lucien",M,30,1920,1974,54,51-60
2813,"Masniuk, Peter Paul",M,30,1920,1974,54,51-60
2814,"Clarke, William Hillary (Bill)",M,32,1933,1980,47,41-50
2815,"Crosby, Howard Edward",M,32,1933,1980,47,41-50
2816,"Flis, Jesse Philip",M,32,1933,1980,47,41-50
2817,"Foster, Maurice Brydon",M,32,1933,1980,47,41-50
2818,"Gamble, John Albert",M,32,1933,1980,47,41-50
2819,"Guay, Raynald Joseph Albert",M,32,1933,1980,47,41-50
2820,"Penner, B. Keith",M,32,1933,1980,47,41-50
2821,"Wright, Frederick William",M,32,1933,1980,47,41-50
2822,"Althouse, Victor Fredrich (Vic)",M,33,1937,1984,47,41-50
2823,"Beatty, Henry Perrin",M,33,1937,1984,47,41-50
2824,"Cassidy, Michael Morris",M,33,1937,1984,47,41-50
2825,"Deans, Ian",M,33,1937,1984,47,41-50
2826,"Gagnon, Paul",M,33,1937,1984,47,41-50
2827,"Landry, Monique",F,33,1937,1984,47,41-50
2828,"Lopez, Ricardo",M,33,1937,1984,47,41-50
2829,"Malone, Arnold John",M,33,1937,1984,47,41-50
2830,"McDougall, Barbara Jean",F,33,1937,1984,47,41-50
2831,"McInnes, Stewart Donald",M,33,1937,1984,47,41-50
2832,"Minaker, Clement George",M,33,1937,1984,47,41-50
2833,"Plourde, André",M,33,1937,1984,47,41-50
2834,"Rodriguez, John R.",M,33,1937,1984,47,41-50
2835,"Wilson, Michael Holcombe",M,33,1937,1984,47,41-50
2836,"Butland, Steve",M,34,1941,1988,47,41-50
2837,"Harvey, André",M,34,1941,1988,47,41-50
2838,"Hudon, Jean-Guy",M,34,1941,1988,47,41-50
2839,"Kilgour, David",M,34,1941,1988,47,41-50
2840,"Leblanc, Nic",M,34,1941,1988,47,41-50
2841,"Peterson, James Scott (Jim)",M,34,1941,1988,47,41-50
2842,"Roy-Arcelin, Nicole",F,34,1941,1988,47,41-50
2843,"Siddon, Thomas Edward",M,34,1941,1988,47,41-50
2844,"Skelly, Raymond John",M,34,1941,1988,47,41-50
2845,"Stewart, Christine Susan",F,34,1941,1988,47,41-50
2846,"Thacker, Blaine Allen",M,34,1941,1988,47,41-50
2847,"Wilson, Geoff",M,34,1941,1988,47,41-50
2848,"Bélisle, Richard",M,35,1946,1993,47,41-50
2849,"Chatters, David Cameron",M,35,1946,1993,47,41-50
2850,"Chrétien, Jean-Guy",M,35,1946,1993,47,41-50
2851,"Collenette, David Michael",M,35,1946,1993,47,41-50
2852,"DeVillers, Paul",M,35,1946,1993,47,41-50
2853,"Forseth, Paul Eugene",M,35,1946,1993,47,41-50
2854,"Gouk, James William (Jim)",M,35,1946,1993,47,41-50
2855,"Lebel, Ghislain",M,35,1946,1993,47,41-50
2856,"MacAulay, Lawrence",M,35,1946,1993,47,41-50
2857,"Milliken, Peter Andrew Stewart",M,35,1946,1993,47,41-50
2858,"Mills, Dennis Joseph",M,35,1946,1993,47,41-50
2859,"Parrish, Carolyn",F,35,1946,1993,47,41-50
2860,"Shepherd, Alexander James",M,35,1946,1993,47,41-50
2861,"Silye, Jim",M,35,1946,1993,47,41-50
2862,"Telegdi, Andrew",M,35,1946,1993,47,41-50
2863,"Ur, Rose-Marie Margaret",F,35,1946,1993,47,41-50
2864,"Wells, Derek",M,35,1946,1993,47,41-50
2865,"Asselin, Gérard",M,36,1950,1997,47,41-50
2866,"Bennett, Carolyn",F,36,1950,1997,47,41-50
2867,"Benoit, Leon Earl",M,36,1950,1997,47,41-50
2868,"Borotsik, Rick",M,36,1950,1997,47,41-50
2869,"Cardin, Serge",M,36,1950,1997,47,41-50
2870,"Day, Stockwell Burt",M,36,1950,1997,47,41-50
2871,"Fontana, Joseph Frank (Joe)",M,36,1950,1997,47,41-50
2872,"Gauthier, Michel",M,36,1950,1997,47,41-50
2873,"Lill, Wendy",F,36,1950,1997,47,41-50
2874,"Manley, John Paul",M,36,1950,1997,47,41-50
2875,"McLellan, A. Anne",F,36,1950,1997,47,41-50
2876,"Obhrai, Deepak",M,36,1950,1997,47,41-50
2877,"Solomon, John Lewis",M,36,1950,1997,47,41-50
2878,"St. Denis, Brent",M,36,1950,1997,47,41-50
2879,"Bertrand, Robert",M,37,1953,2000,47,41-50
2880,"Bulte, Sarmite D.",F,37,1953,2000,47,41-50
2881,"Crête, Paul",M,37,1953,2000,47,41-50
2882,"Davies, Libby",F,37,1953,2000,47,41-50
2883,"Guarnieri, Albina",F,37,1953,2000,47,41-50
2884,"Guimond, Michel",M,37,1953,2000,47,41-50
2885,"Keddy, Gerald",M,37,1953,2000,47,41-50
2886,"Keyes, Stan Kazmierczak",M,37,1953,2000,47,41-50
2887,"Merrifield, Rob",M,37,1953,2000,47,41-50
2888,"Redman, Karen",F,37,1953,2000,47,41-50
2889,"St-Jacques, Diane",F,37,1953,2000,47,41-50
2890,"Anderson, David",M,38,1957,2004,47,41-50
2891,"Anderson, David",M,38,1957,2004,47,41-50
2892,"Anderson, David",M,38,1957,2004,47,41-50
2893,"Anderson, David",M,38,1957,2004,47,41-50
2894,"Finley, Diane",F,38,1957,2004,47,41-50
2895,"Grewal, Gurmant Singh",M,38,1957,2004,47,41-50
2896,"Ianno, Tony",M,38,1957,2004,47,41-50
2897,"Karetak-Lindell, Nancy",F,38,1957,2004,47,41-50
2898,"Laframboise, Mario",M,38,1957,2004,47,41-50
2899,"Lunn, Gary",M,38,1957,2004,47,41-50
2900,"Scarpaleggia, Francis",M,38,1957,2004,47,41-50
2901,"Strahl, Charles (Chuck)",M,38,1957,2004,47,41-50
2902,"Valeri, Tony",M,38,1957,2004,47,41-50
2903,"Valley, Roger",M,38,1957,2004,47,41-50
2904,"André, Guy",M,39,1959,2006,47,41-50
2905,"Deschamps, Johanne",F,39,1959,2006,47,41-50
2906,"Guay, Monique",F,39,1959,2006,47,41-50
2907,"Hall Findlay, Martha",F,39,1959,2006,47,41-50
2908,"Harper, Stephen",M,39,1959,2006,47,41-50
2909,"Loubier, Yvan",M,39,1959,2006,47,41-50
2910,"Nadeau, Richard",M,39,1959,2006,47,41-50
2911,"Regan, Geoff",M,39,1959,2006,47,41-50
2912,"Thibault, Robert",M,39,1959,2006,47,41-50
2913,"Beaudin, Josée",F,40,1961,2008,47,41-50
2914,"Block, Kelly",F,40,1961,2008,47,41-50
2915,"Cannan, Ronald",M,40,1961,2008,47,41-50
2916,"Clement, Tony",M,40,1961,2008,47,41-50
2917,"Murphy, Brian",M,40,1961,2008,47,41-50
2918,"Rota, Anthony",M,40,1961,2008,47,41-50
2919,"Bellavance, André",M,41,1964,2011,47,41-50
2920,"Braid, Peter",M,41,1964,2011,47,41-50
2921,"Gourde, Jacques",M,41,1964,2011,47,41-50
2922,"Hsu, Ted",M,41,1964,2011,47,41-50
2923,"Kellway, Matthew",M,41,1964,2011,47,41-50
2924,"Penashue, Peter",M,41,1964,2011,47,41-50
2925,"Rathgeber, Brent",M,41,1964,2011,47,41-50
2926,"Reid, Scott",M,41,1964,2011,47,41-50
2927,"Saxton, Andrew",M,41,1964,2011,47,41-50
2928,"Weston, Rodney",M,40,1964,2008,44,41-50
2929,"Alleslev, Leona",F,42,1968,2015,47,41-50
2930,"Blaney, Rachel",F,42,1968,2015,47,41-50
2931,"Calkins, Blaine",M,42,1968,2015,47,41-50
2932,"Caron, Guy",M,42,1968,2015,47,41-50
2933,"Freeland, Chrystia",F,42,1968,2015,47,41-50
2934,"Jones, Yvonne",F,42,1968,2015,47,41-50
2935,"Kenney, Jason",M,42,1968,2015,47,41-50
2936,"Lefebvre, Paul",M,42,1968,2015,47,41-50
2937,"Masse, Brian",M,42,1968,2015,47,41-50
2938,"Raitt, Lisa",F,42,1968,2015,47,41-50
2939,"Sidhu, Sonia",F,42,1968,2015,47,41-50
2940,"Zimmer, Bob",M,41,1968,2011,43,41-50
2941,"McPherson, Heather",F,43,1972,2019,47,41-50
2942,"Corbett, Robert Alfred",M,33,1938,1984,46,41-50
2943,"Andras, Robert Knight",M,30,1921,1974,53,51-60
2944,"Danson, Barnett Jerome",M,30,1921,1974,53,51-60
2945,"Gilbert, John",M,30,1921,1974,53,51-60
2946,"Hamilton, Frank Fletcher",M,30,1921,1974,53,51-60
2947,"Jamieson, Donald Campbell",M,30,1921,1974,53,51-60
2948,"Kempling, William James",M,30,1921,1974,53,51-60
2949,"Loiselle, Gérard",M,30,1921,1974,53,51-60
2950,"Mackasey, Bryce Stuart",M,30,1921,1974,53,51-60
2951,"Morin, Albanie",F,30,1921,1974,53,51-60
2952,"Neale, Charles Patrick (Paddy)",M,30,1921,1974,53,51-60
2953,"Saltsman, Max",M,30,1921,1974,53,51-60
2954,"Scott, William C.",M,30,1921,1974,53,51-60
2955,"Smith, G.A. Percy",M,30,1921,1974,53,51-60
2956,"McCleave, Robert Jardine",M,30,1922,1974,52,51-60
2957,"Alexander, Lincoln MacCauley",M,30,1922,1974,52,51-60
2958,"Béchard, Albert",M,30,1922,1974,52,51-60
2959,"Cyr, Alexandre",M,30,1922,1974,52,51-60
2960,"Gillespie, Alastair William",M,30,1922,1974,52,51-60
2961,"Herbert, Harold Thomas",M,30,1922,1974,52,51-60
2962,"Peters, William Arnold",M,30,1922,1974,52,51-60
2963,"Richardson, James Armstrong",M,30,1922,1974,52,51-60
2964,"Sauvé, Jeanne",F,30,1922,1974,52,51-60
2965,"Skoreyko, William",M,30,1922,1974,52,51-60
2966,"Yanakis, Antonio",M,30,1922,1974,52,51-60
2967,"Bell, Thomas Miller",M,30,1923,1974,51,51-60
2968,"Dupras, Maurice",M,30,1923,1974,51,51-60
2969,"Fairweather, Robert Gordon Lee",M,30,1923,1974,51,51-60
2970,"Frank, William Charles",M,30,1923,1974,51,51-60
2971,"Hellyer, Paul Theodore",M,30,1923,1974,51,51-60
2972,"Morgan, J. Trevor",M,30,1923,1974,51,51-60
2973,"Roy, Jean Robert",M,30,1923,1974,51,51-60
2974,"Arrol, Ian MacLachlan",M,30,1924,1974,50,41-50
2975,"Beaudoin, Léonel",M,30,1924,1974,50,41-50
2976,"Gillies, James McPhail",M,30,1924,1974,50,41-50
2977,"Laniel, Gérald",M,30,1924,1974,50,41-50
2978,"McKenzie, A. Daniel",M,30,1924,1974,50,41-50
2979,"McRae, Paul Edmund",M,30,1924,1974,50,41-50
2980,"Neil, Douglas Charles",M,30,1924,1974,50,41-50
2981,"Nielsen, Erik",M,30,1924,1974,50,41-50
2982,"Rose, Mark Willson",M,30,1924,1974,50,41-50
2983,"Laflamme, Ovide",M,30,1925,1974,49,41-50
2984,"Benjamin, Leslie Gordon",M,30,1925,1974,49,41-50
2985,"Howard, Frank",M,30,1925,1974,49,41-50
2986,"Laprise, Gérard",M,30,1925,1974,49,41-50
2987,"Lawrence, Allan Frederick",M,30,1925,1974,49,41-50
2988,"Stackhouse, Reginald Francis",M,30,1925,1974,49,41-50
2989,"Bachand, André",M,32,1934,1980,46,41-50
2990,"Bachand, André",M,32,1934,1980,46,41-50
2991,"Blackburn, Derek Nigel Ernest",M,32,1934,1980,46,41-50
2992,"Cardiff, Murray",M,32,1934,1980,46,41-50
2993,"Chrétien, Joseph Jacques Jean",M,32,1934,1980,46,41-50
2994,"Cosgrove, Paul James",M,32,1934,1980,46,41-50
2995,"Côté, Eva Lachance",F,32,1934,1980,46,41-50
2996,"Erola, Judith A.",F,32,1934,1980,46,41-50
2997,"Hawkes, Frederick James (Jim)",M,32,1934,1980,46,41-50
2998,"Hnatyshyn, Ramon John",M,32,1934,1980,46,41-50
2999,"MacLaren, Roy",M,32,1934,1980,46,41-50
3000,"Watson, Ian",M,32,1934,1980,46,41-50
3001,"Bouchard, Lucien",M,33,1938,1984,46,41-50
3002,"Bradley, T.A. Bud",M,33,1938,1984,46,41-50
3003,"Browes, Pauline",F,33,1938,1984,46,41-50
3004,"Clifford, Terrence (Terry)",M,33,1938,1984,46,41-50
3005,"Gass, Melbourne Alexander",M,33,1938,1984,46,41-50
3006,"Hockin, Thomas",M,33,1938,1984,46,41-50
3007,"Lewis, Douglas Grinslade",M,33,1938,1984,46,41-50
3008,"Mailly, Claudy",F,33,1938,1984,46,41-50
3009,"Malépart, Jean-Claude",M,33,1938,1984,46,41-50
3010,"Scott, Geoffrey Douglas",M,33,1938,1984,46,41-50
3011,"Breaugh, Michael James",M,34,1942,1988,46,41-50
3012,"Cole, John",M,34,1942,1988,46,41-50
3013,"de Jong, Simon Leendert",M,34,1942,1988,46,41-50
3014,"Ferland, Marc",M,34,1942,1988,46,41-50
3015,"Gagliano, Alfonso",M,34,1942,1988,46,41-50
3016,"Ricard, Guy",M,34,1942,1988,46,41-50
3017,"Riis, Nelson Andrew",M,34,1942,1988,46,41-50
3018,"Waddell, Ian Gardiner",M,34,1942,1988,46,41-50
3019,"Axworthy, Chris",M,35,1947,1993,46,41-50
3020,"Bernier, Maurice",M,35,1947,1993,46,41-50
3021,"Brown, Jan",F,35,1947,1993,46,41-50
3022,"Dubé, Antoine",M,35,1947,1993,46,41-50
3023,"Duceppe, Gilles",M,35,1947,1993,46,41-50
3024,"Gerrard, Jon",M,35,1947,1993,46,41-50
3025,"Hanrahan, Hugh F.",M,35,1947,1993,46,41-50
3026,"Jacob, Jean-Marc",M,35,1947,1993,46,41-50
3027,"Picard, Pauline",F,35,1947,1993,46,41-50
3028,"Pomerleau, Roger",M,35,1947,1993,46,41-50
3029,"Rock, Allan",M,35,1947,1993,46,41-50
3030,"Volpe, Giuseppe (Joseph)",M,35,1947,1993,46,41-50
3031,"Walker, David",M,35,1947,1993,46,41-50
3032,"Bachand, Claude",M,36,1951,1997,46,41-50
3033,"Blaikie, William Alexander (Bill)",M,36,1951,1997,46,41-50
3034,"Blondin-Andrew, Ethel Dorothy",F,36,1951,1997,46,41-50
3035,"Calder, Murray",M,36,1951,1997,46,41-50
3036,"Cannis, John",M,36,1951,1997,46,41-50
3037,"Chan, Raymond",M,36,1951,1997,46,41-50
3038,"Desrochers, Odina",M,36,1951,1997,46,41-50
3039,"Jennings, Marlene",F,36,1951,1997,46,41-50
3040,"Murray, Ian",M,36,1951,1997,46,41-50
3041,"Myers, Lynn",M,36,1951,1997,46,41-50
3042,"O'Brien, Lawrence D.",M,36,1951,1997,46,41-50
3043,"Pettigrew, Pierre Stewart",M,36,1951,1997,46,41-50
3044,"Ritz, Gerry",M,36,1951,1997,46,41-50
3045,"Serré, Benoît",M,36,1951,1997,46,41-50
3046,"Bakopanos, Eleni",F,37,1954,2000,46,41-50
3047,"Duplain, Claude",M,37,1954,2000,46,41-50
3048,"Pallister, Brian William",M,37,1954,2000,46,41-50
3049,"Tobin, Brian Vincent",M,37,1954,2000,46,41-50
3050,"Goodyear, Gary",M,38,1958,2004,46,41-50
3051,"Grewal, Nina",F,38,1958,2004,46,41-50
3052,"Simard, Raymond",M,38,1958,2004,46,41-50
3053,"Solberg, Monte",M,38,1958,2004,46,41-50
3054,"Sorenson, Kevin",M,38,1958,2004,46,41-50
3055,"Allen, Mike",M,39,1960,2006,46,41-50
3056,"Bevilacqua, Maurizio",M,39,1960,2006,46,41-50
3057,"Brown, Gordon",M,39,1960,2006,46,41-50
3058,"Dhaliwal, Sukh",M,39,1960,2006,46,41-50
3059,"Eyking, Mark",M,39,1960,2006,46,41-50
3060,"Gallant, Cheryl",F,39,1960,2006,46,41-50
3061,"Martin, Keith P.",M,39,1960,2006,46,41-50
3062,"McGuinty, David",M,39,1960,2006,46,41-50
3063,"Wrzesnewskyj, Borys",M,38,1960,2004,44,41-50
3064,"Angus, Charlie",M,40,1962,2008,46,41-50
3065,"Boucher, Sylvie",F,40,1962,2008,46,41-50
3066,"Carrie, Colin",M,40,1962,2008,46,41-50
3067,"Généreux, Bernard",M,40,1962,2008,46,41-50
3068,"Julian, Peter",M,40,1962,2008,46,41-50
3069,"Lamoureux, Kevin",M,40,1962,2008,46,41-50
3070,"McTeague, Dan",M,40,1962,2008,46,41-50
3071,"Ménard, Réal",M,40,1962,2008,46,41-50
3072,"Pacetti, Massimo",M,40,1962,2008,46,41-50
3073,"Allison, Dean",M,41,1965,2011,46,41-50
3074,"Bezan, James",M,41,1965,2011,46,41-50
3075,"Blaney, Steven",M,41,1965,2011,46,41-50
3076,"MacKay, Peter Gordon",M,41,1965,2011,46,41-50
3077,"Perreault, Manon",F,41,1965,2011,46,41-50
3078,"Trottier, Bernard",M,41,1965,2011,46,41-50
3079,"Alghabra, Omar",M,42,1969,2015,46,41-50
3080,"Ambrose, Rona",F,42,1969,2015,46,41-50
3081,"Fergus, Greg",M,42,1969,2015,46,41-50
3082,"Fortier, Mona",F,42,1969,2015,46,41-50
3083,"Fuhr, Stephen",M,42,1969,2015,46,41-50
3084,"Hehr, Kent",M,42,1969,2015,46,41-50
3085,"Johns, Gord",M,42,1969,2015,46,41-50
3086,"Kusie, Stephanie",F,42,1969,2015,46,41-50
3087,"Lake, Mike",M,42,1969,2015,46,41-50
3088,"Ng, Mary",F,42,1969,2015,46,41-50
3089,"Paul-Hus, Pierre",M,42,1969,2015,46,41-50
3090,"Petitpas Taylor, Ginette",F,42,1969,2015,46,41-50
3091,"Sarai, Randeep",M,42,1969,2015,46,41-50
3092,"Simms, Scott",M,42,1969,2015,46,41-50
3093,"Aitchison, Scott",M,43,1973,2019,46,41-50
3094,"Boulerice, Alexandre",M,43,1973,2019,46,41-50
3095,"Housefather, Anthony",M,43,1973,2019,46,41-50
3096,"MacGregor, Alistair",M,43,1973,2019,46,41-50
3097,"Mendicino, Marco",M,43,1973,2019,46,41-50
3098,"Miller, Marc",M,43,1973,2019,46,41-50
3099,"O'Toole, Erin",M,43,1973,2019,46,41-50
3100,"Ruff, Alex",M,43,1973,2019,46,41-50
3101,"Saks, Ya'ara",F,43,1973,2019,46,41-50
3102,"Whalen, Nick",M,42,1973,2015,42,41-50
3103,"Corriveau, Léopold",M,30,1926,1974,48,41-50
3104,"Dubé, Jean-Eudes",M,30,1926,1974,48,41-50
3105,"Éthier, Denis",M,30,1926,1974,48,41-50
3106,"Godin, Roland",M,30,1926,1974,48,41-50
3107,"Lachance, Georges-C.",M,30,1926,1974,48,41-50
3108,"Langlois, Paul",M,30,1926,1974,48,41-50
3109,"Lessard, Marcel",M,30,1926,1974,48,41-50
3110,"Cossitt, Thomas Charles",M,30,1927,1974,47,41-50
3111,"Cullen, Jack Sydney George (Bud)",M,30,1927,1974,47,41-50
3112,"Hollands, Daniel Fulton",M,30,1927,1974,47,41-50
3113,"Holmes, John Robert",M,30,1927,1974,47,41-50
3114,"Horner, John (Jack) Henry",M,30,1927,1974,47,41-50
3115,"Stevens, Sinclair McKnight",M,30,1927,1974,47,41-50
3116,"Rondeau, Gilbert F.",M,30,1928,1974,46,41-50
3117,"Cafik, Norman Augustine",M,30,1928,1974,46,41-50
3118,"Coates, Robert Carman",M,30,1928,1974,46,41-50
3119,"Grafftey, William Heward",M,30,1928,1974,46,41-50
3120,"Hurlburt, Kenneth Earl",M,30,1928,1974,46,41-50
3121,"La Salle, Roch",M,30,1928,1974,46,41-50
3122,"Lajoie, Claude G.",M,30,1928,1974,46,41-50
3123,"Marceau, Gilles",M,30,1928,1974,46,41-50
3124,"McKinley, Robert Elgin",M,30,1928,1974,46,41-50
3125,"Paproski, Steve Eugene",M,30,1928,1974,46,41-50
3126,"Portelance, Arthur",M,30,1928,1974,46,41-50
3127,"Stewart, Donald Craig",M,30,1928,1974,46,41-50
3128,"Côté, Florian",M,30,1929,1974,45,41-50
3129,"Kuntz, Harry",M,30,1929,1974,45,41-50
3130,"Bawden, Peter Colwell",M,30,1929,1974,45,41-50
3131,"Beattie, Duncan M.",M,30,1929,1974,45,41-50
3132,"Buchanan, J. Judd",M,30,1929,1974,45,41-50
3133,"Carter, Walter C.",M,30,1929,1974,45,41-50
3134,"Comtois, Joseph-Roland",M,30,1929,1974,45,41-50
3135,"Ellis, John Raymond",M,30,1929,1974,45,41-50
3136,"Howie, J. Robert",M,30,1929,1974,45,41-50
3137,"Korchinski, Stanley James",M,30,1929,1974,45,41-50
3138,"Lalonde, Marc",M,30,1929,1974,45,41-50
3139,"Olaussen, Harry Magnus",M,30,1929,1974,45,41-50
3140,"Stanbury, Robert Douglas George",M,30,1929,1974,45,41-50
3141,"Stewart, Ralph Wesley",M,30,1929,1974,45,41-50
3142,"Turner, John Napier",M,30,1929,1974,45,41-50
3143,"Baker, Walter David",M,30,1930,1974,44,41-50
3144,"Blenkarn, Donald Alex",M,30,1930,1974,44,41-50
3145,"Caccia, Charles L.",M,30,1930,1974,44,41-50
3146,"Hopkins, Leonard Donald",M,30,1930,1974,44,41-50
3147,"Chénier, Jacques Raymond (Ray)",M,32,1935,1980,45,41-50
3148,"Henderson, George Roland",M,32,1935,1980,45,41-50
3149,"Mazankowski, Donald Frank",M,32,1935,1980,45,41-50
3150,"Parent, Gilbert",M,32,1935,1980,45,41-50
3151,"Schreyer, Edward Richard",M,32,1935,1980,45,41-50
3152,"Wise, John",M,32,1935,1980,45,41-50
3153,"Axworthy, Lloyd",M,33,1939,1984,45,41-50
3154,"Clark, Charles Joseph",M,33,1939,1984,45,41-50
3155,"Epp, Arthur Jacob (Jake)",M,33,1939,1984,45,41-50
3156,"Gravel, Michel",M,33,1939,1984,45,41-50
3157,"Mulroney, Martin Brian",M,33,1939,1984,45,41-50
3158,"Ouellet, André",M,33,1939,1984,45,41-50
3159,"Black, Dawn",F,34,1943,1988,45,41-50
3160,"Danis, Marcel",M,34,1943,1988,45,41-50
3161,"Della Noce, Vincent",M,34,1943,1988,45,41-50
3162,"Langan, Joy",F,34,1943,1988,45,41-50
3163,"Marleau, Diane",F,34,1943,1988,45,41-50
3164,"McCreath, Peter L.",M,34,1943,1988,45,41-50
3165,"Plamondon, Louis",M,34,1943,1988,45,41-50
3166,"Samson, Cyril (Cid)",M,34,1943,1988,45,41-50
3167,"Skelly, Robert Evans",M,34,1943,1988,45,41-50
3168,"Tremblay, Marcel R.",M,34,1943,1988,45,41-50
3169,"Vanclief, Lyle",M,34,1943,1988,45,41-50
3170,"Vankoughnet, William John",M,34,1943,1988,45,41-50
3171,"Alcock, Reginald B.",M,35,1948,1993,45,41-50
3172,"Assadourian, Sarkis",M,35,1948,1993,45,41-50
3173,"Bodnar, Morris P.",M,35,1948,1993,45,41-50
3174,"Clancy, Mary Catherine",F,35,1948,1993,45,41-50
3175,"Cohen, Elizabeth Shaughnessy",F,35,1948,1993,45,41-50
3176,"Duncan, John",M,35,1948,1993,45,41-50
3177,"Gagnon, Christiane",F,35,1948,1993,45,41-50
3178,"Gallaway, Roger John",M,35,1948,1993,45,41-50
3179,"Hayes, Sharon Ruth",F,35,1948,1993,45,41-50
3180,"Landry, Jean",M,35,1948,1993,45,41-50
3181,"Langlois, François",M,35,1948,1993,45,41-50
3182,"Lee, Derek Vincent",M,35,1948,1993,45,41-50
3183,"Leroux, Gaston",M,35,1948,1993,45,41-50
3184,"Minna, Maria",F,35,1948,1993,45,41-50
3185,"O'Brien, Pat",M,35,1948,1993,45,41-50
3186,"Szabo, Paul John Mark",M,35,1948,1993,45,41-50
3187,"Tremblay, Benoît",M,35,1948,1993,45,41-50
3188,"Barnes, Susan (Sue)",F,36,1952,1997,45,41-50
3189,"Chamberlain, Brenda",F,36,1952,1997,45,41-50
3190,"Copps, Sheila Maureen",F,36,1952,1997,45,41-50
3191,"Dhaliwal, Harbance Singh (Herb)",M,36,1952,1997,45,41-50
3192,"Grey, Deborah C.",F,36,1952,1997,45,41-50
3193,"Hill, Jay D.",M,36,1952,1997,45,41-50
3194,"Kraft Sloan, Karen",F,36,1952,1997,45,41-50
3195,"Robinson, Svend Johannes",M,36,1952,1997,45,41-50
3196,"Bélanger, Mauril",M,37,1955,2000,45,41-50
3197,"Binet, Gérard",M,37,1955,2000,45,41-50
3198,"Cuzner, Rodger",M,37,1955,2000,45,41-50
3199,"Desjarlais, Bev",F,37,1955,2000,45,41-50
3200,"Dion, Stéphane",M,37,1955,2000,45,41-50
3201,"Godin, Yvon",M,37,1955,2000,45,41-50
3202,"Karygiannis, Jim",M,37,1955,2000,45,41-50
3203,"Martin, Pat",M,37,1955,2000,45,41-50
3204,"Nault, Robert Daniel",M,37,1955,2000,45,41-50
3205,"Paquette, Pierre A.",M,37,1955,2000,45,41-50
3206,"Pratt, David",M,37,1955,2000,45,41-50
3207,"Scott, Andy",M,37,1955,2000,45,41-50
3208,"Stewart, Jane",F,37,1955,2000,45,41-50
3209,"Vellacott, Maurice",M,37,1955,2000,45,41-50
3210,"André, Guy",M,38,1959,2004,45,41-50
3211,"Deschamps, Johanne",F,38,1959,2004,45,41-50
3212,"Guay, Monique",F,38,1959,2004,45,41-50
3213,"Harper, Stephen",M,38,1959,2004,45,41-50
3214,"Loubier, Yvan",M,38,1959,2004,45,41-50
3215,"Regan, Geoff",M,38,1959,2004,45,41-50
3216,"Thibault, Robert",M,38,1959,2004,45,41-50
3217,"Cannan, Ronald",M,39,1961,2006,45,41-50
3218,"Clement, Tony",M,39,1961,2006,45,41-50
3219,"Kotto, Maka",M,39,1961,2006,45,41-50
3220,"Murphy, Brian",M,39,1961,2006,45,41-50
3221,"Rota, Anthony",M,39,1961,2006,45,41-50
3222,"Bernier, Maxime",M,40,1963,2008,45,41-50
3223,"Charlton, Chris",F,40,1963,2008,45,41-50
3224,"Coderre, Denis",M,40,1963,2008,45,41-50
3225,"Davies, Don",M,40,1963,2008,45,41-50
3226,"DeBellefeuille, Claude",F,40,1963,2008,45,41-50
3227,"Devolin, Barry",M,40,1963,2008,45,41-50
3228,"Dewar, Paul",M,40,1963,2008,45,41-50
3229,"Guimond, Claude",M,40,1963,2008,45,41-50
3230,"Jean, Brian",M,40,1963,2008,45,41-50
3231,"Lemieux, Pierre",M,40,1963,2008,45,41-50
3232,"Mendès, Alexandra",F,40,1963,2008,45,41-50
3233,"Van Loan, Peter",M,40,1963,2008,45,41-50
3234,"Wallace, Mike",M,39,1963,2006,43,41-50
3235,"Wilson, Blair",M,39,1963,2006,43,41-50
3236,"Ambler, Stella",F,41,1966,2011,45,41-50
3237,"Armstrong, Scott",M,41,1966,2011,45,41-50
3238,"Byrne, Gerry",M,41,1966,2011,45,41-50
3239,"Cleary, Ryan",M,41,1966,2011,45,41-50
3240,"Donnelly, Fin",M,41,1966,2011,45,41-50
3241,"Duncan, Kirsty",F,41,1966,2011,45,41-50
3242,"Dykstra, Richard",M,41,1966,2011,45,41-50
3243,"Sandhu, Jasbir",M,41,1966,2011,45,41-50
3244,"Stewart, Kennedy",M,41,1966,2011,45,41-50
3245,"Bibeau, Marie-Claude",F,42,1970,2015,45,41-50
3246,"Boissonnault, Randy",M,42,1970,2015,45,41-50
3247,"Champagne, François-Philippe",M,42,1970,2015,45,41-50
3248,"Ehsassi, Ali",M,42,1970,2015,45,41-50
3249,"Hussen, Ahmed",M,42,1970,2015,45,41-50
3250,"Leitch, K. Kellie",F,42,1970,2015,45,41-50
3251,"Sajjan, Harjit Singh",M,42,1970,2015,45,41-50
3252,"Amos, William",M,43,1974,2019,45,41-50
3253,"Boudrias, Michel",M,43,1974,2019,45,41-50
3254,"Bragdon, Richard",M,43,1974,2019,45,41-50
3255,"Holland, Mark",M,43,1974,2019,45,41-50
3256,"Lewis, Chris",M,43,1974,2019,45,41-50
3257,"May, Bryan",M,43,1974,2019,45,41-50
3258,"Moore, Rob",M,43,1974,2019,45,41-50
3259,"Richards, Blake",M,43,1974,2019,45,41-50
3260,"Romanado, Sherry",F,43,1974,2019,45,41-50
3261,"Uppal, Tim",M,43,1974,2019,45,41-50
3262,"Dionne, Maurice Adrian",M,32,1936,1980,44,41-50
3263,"Horner, Norval Alic",M,30,1930,1974,44,41-50
3264,"Jarvis, William Herbert",M,30,1930,1974,44,41-50
3265,"Fraser, John Allen",M,30,1931,1974,43,41-50
3266,"Gray, Herbert Eser (Herb)",M,30,1931,1974,43,41-50
3267,"Harney, John Paul",M,30,1931,1974,43,41-50
3268,"Leggatt, Stuart Malcolm",M,30,1931,1974,43,41-50
3269,"MacGuigan, Mark R.",M,30,1931,1974,43,41-50
3270,"Munro, John Carr",M,30,1931,1974,43,41-50
3271,"Nesdoly, Elias (Eli)",M,30,1931,1974,43,41-50
3272,"Nowlan, John Patrick (Pat)",M,30,1931,1974,43,41-50
3273,"Poulin, Fabian Hugh",M,30,1931,1974,43,41-50
3274,"Taylor, Charles Keith",M,30,1931,1974,43,41-50
3275,"Allmand, William Warren",M,30,1932,1974,42,41-50
3276,"Basford, Stanley Ronald",M,30,1932,1974,42,41-50
3277,"Goyer, Jean-Pierre",M,30,1932,1974,42,41-50
3278,"Lang, Otto Emil",M,30,1932,1974,42,41-50
3279,"Macdonald, Donald Stovel",M,30,1932,1974,42,41-50
3280,"McGrath, James Aloysius",M,30,1932,1974,42,41-50
3281,"Oberle, Frank",M,30,1932,1974,42,41-50
3282,"Yewchuk, Paul",M,30,1937,1974,37,31-40
3283,"Clarke, William Hillary (Bill)",M,30,1933,1974,41,41-50
3284,"Faulkner, James Hugh",M,30,1933,1974,41,41-50
3285,"Foster, Maurice Brydon",M,30,1933,1974,41,41-50
3286,"Bégin, Monique",F,32,1936,1980,44,41-50
3287,"Blaker, Roderick",M,32,1936,1980,44,41-50
3288,"Broadbent, John Edward",M,32,1936,1980,44,41-50
3289,"Campbell, John",M,32,1936,1980,44,41-50
3290,"Clark, Walter Leland Rutherford (Lee)",M,32,1936,1980,44,41-50
3291,"Crombie, David Edward",M,32,1936,1980,44,41-50
3292,"Guilbault, Jacques",M,32,1936,1980,44,41-50
3293,"Irwin, Ron",M,32,1936,1980,44,41-50
3294,"Johnston, Donald James",M,32,1936,1980,44,41-50
3295,"Kaplan, Robert Phillip",M,32,1936,1980,44,41-50
3296,"MacKay, Elmer MacIntosh",M,32,1936,1980,44,41-50
3297,"Mayer, Charles James",M,32,1936,1980,44,41-50
3298,"McLean, Walter Franklin",M,32,1936,1980,44,41-50
3299,"Roy, Marcel-Claude",M,32,1936,1980,44,41-50
3300,"Andre, Harvie",M,33,1940,1984,44,41-50
3301,"Bouchard, Benoît",M,33,1940,1984,44,41-50
3302,"Collins, Mary",F,33,1940,1984,44,41-50
3303,"Côté, Clément M.",M,33,1940,1984,44,41-50
3304,"Dick, Paul Wyatt",M,33,1940,1984,44,41-50
3305,"Fontaine, Gabriel",M,33,1940,1984,44,41-50
3306,"Jelinek, Otto John",M,33,1940,1984,44,41-50
3307,"MacLellan, Russell Gregoire",M,33,1940,1984,44,41-50
3308,"McDermid, John Horton",M,33,1940,1984,44,41-50
3309,"McDonald, Lynn",F,33,1940,1984,44,41-50
3310,"McKnight, William Hunter (Bill)",M,33,1940,1984,44,41-50
3311,"Ravis, Donald Paul",M,33,1940,1984,44,41-50
3312,"St-Julien, Guy",M,33,1940,1984,44,41-50
3313,"Wenman, Robert Lloyd",M,33,1940,1984,44,41-50
3314,"Edmonston, Philip",M,34,1944,1988,44,41-50
3315,"Fee, Douglas",M,34,1944,1988,44,41-50
3316,"Gérin, François",M,34,1944,1988,44,41-50
3317,"Grisé, Richard",M,34,1944,1988,44,41-50
3318,"Holtmann, Felix",M,34,1944,1988,44,41-50
3319,"Kilger, Robert (Bob)",M,34,1944,1988,44,41-50
3320,"Littlechild, Wilton (Willie)",M,34,1944,1988,44,41-50
3321,"McGuire, Joseph Blair (Joe)",M,34,1944,1988,44,41-50
3322,"Moore, Barry D.",M,34,1944,1988,44,41-50
3323,"Tremblay, Maurice",M,34,1944,1988,44,41-50
3324,"Whittaker, John R. (Jack)",M,34,1944,1988,44,41-50
3325,"Ablonczy, Diane",F,35,1949,1993,44,41-50
3326,"Bélair, Réginald",M,35,1949,1993,44,41-50
3327,"Boudria, Don",M,35,1949,1993,44,41-50
3328,"Discepola, Nunzio (Nick)",M,35,1949,1993,44,41-50
3329,"Easter, Wayne",M,35,1949,1993,44,41-50
3330,"Goodale, Ralph",M,35,1949,1993,44,41-50
3331,"Harper, Elijah",M,35,1949,1993,44,41-50
3332,"Leroux, Jean H.",M,35,1949,1993,44,41-50
3333,"Malhi, Gurbax Singh",M,35,1949,1993,44,41-50
3334,"Meredith, Valerie (Val)",F,35,1949,1993,44,41-50
3335,"Paradis, Denis",M,35,1949,1993,44,41-50
3336,"Peric, Janko",M,35,1949,1993,44,41-50
3337,"Bertrand, Robert",M,36,1953,1997,44,41-50
3338,"Bulte, Sarmite D.",F,36,1953,1997,44,41-50
3339,"Crête, Paul",M,36,1953,1997,44,41-50
3340,"Davies, Libby",F,36,1953,1997,44,41-50
3341,"Guarnieri, Albina",F,36,1953,1997,44,41-50
3342,"Guimond, Michel",M,36,1953,1997,44,41-50
3343,"Keddy, Gerald",M,36,1953,1997,44,41-50
3344,"Keyes, Stan Kazmierczak",M,36,1953,1997,44,41-50
3345,"Redman, Karen",F,36,1953,1997,44,41-50
3346,"St-Jacques, Diane",F,36,1953,1997,44,41-50
3347,"Drouin, Claude",M,37,1956,2000,44,41-50
3348,"Knutson, Gar",M,37,1956,2000,44,41-50
3349,"Mitchell, Andrew (Andy)",M,37,1956,2000,44,41-50
3350,"Speller, Robert (Bob)",M,37,1956,2000,44,41-50
3351,"Stoffer, Peter",M,37,1956,2000,44,41-50
3352,"Bevilacqua, Maurizio",M,38,1960,2004,44,41-50
3353,"Boivin, Françoise",F,38,1960,2004,44,41-50
3354,"Brown, Gordon",M,38,1960,2004,44,41-50
3355,"Eyking, Mark",M,38,1960,2004,44,41-50
3356,"Gallant, Cheryl",F,38,1960,2004,44,41-50
3357,"Martin, Keith P.",M,38,1960,2004,44,41-50
3358,"McGuinty, David",M,38,1960,2004,44,41-50
3359,"Angus, Charlie",M,39,1962,2006,44,41-50
3360,"Boucher, Sylvie",F,39,1962,2006,44,41-50
3361,"Carrie, Colin",M,39,1962,2006,44,41-50
3362,"Julian, Peter",M,39,1962,2006,44,41-50
3363,"Keeper, Tina",F,39,1962,2006,44,41-50
3364,"McTeague, Dan",M,39,1962,2006,44,41-50
3365,"Ménard, Réal",M,39,1962,2006,44,41-50
3366,"Pacetti, Massimo",M,39,1962,2006,44,41-50
3367,"Bellavance, André",M,40,1964,2008,44,41-50
3368,"Braid, Peter",M,40,1964,2008,44,41-50
3369,"Gourde, Jacques",M,40,1964,2008,44,41-50
3370,"Rathgeber, Brent",M,40,1964,2008,44,41-50
3371,"Reid, Scott",M,40,1964,2008,44,41-50
3372,"Saxton, Andrew",M,40,1964,2008,44,41-50
3373,"Aglukkaq, Leona",F,41,1967,2011,44,41-50
3374,"Brison, Scott",M,41,1967,2011,44,41-50
3375,"Butt, Brad",M,41,1967,2011,44,41-50
3376,"Chan, Arnold",M,41,1967,2011,44,41-50
3377,"Clarke, Rob",M,41,1967,2011,44,41-50
3378,"Côté, Raymond",M,41,1967,2011,44,41-50
3379,"Glover, Shelly",F,41,1967,2011,44,41-50
3380,"Hoback, Randy",M,41,1967,2011,44,41-50
3381,"LeBlanc, Dominic",M,41,1967,2011,44,41-50
3382,"Rickford, Greg",M,41,1967,2011,44,41-50
3383,"Barlow, John",M,42,1971,2015,44,41-50
3384,"Chong, Michael D.",M,42,1971,2015,44,41-50
3385,"Dabrusin, Julie",F,42,1971,2015,44,41-50
3386,"Damoff, Pam",F,42,1971,2015,44,41-50
3387,"Kelly, Pat",M,42,1971,2015,44,41-50
3388,"McKenna, Catherine",F,42,1971,2015,44,41-50
3389,"O'Regan, Seamus",M,42,1971,2015,44,41-50
3390,"Peterson, Kyle",M,42,1971,2015,44,41-50
3391,"Qualtrough, Carla",F,42,1971,2015,44,41-50
3392,"Ramsey, Tracey",F,42,1971,2015,44,41-50
3393,"Rayes, Alain",M,42,1971,2015,44,41-50
3394,"Sorbara, Francesco",M,42,1971,2015,44,41-50
3395,"Trudeau, Justin",M,42,1971,2015,44,41-50
3396,"Vandenbeld, Anita",F,42,1971,2015,44,41-50
3397,"Vecchio, Karen",F,42,1971,2015,44,41-50
3398,"Watson, Jeff",M,41,1971,2011,40,31-40
3399,"Bessette, Lyne",F,43,1975,2019,44,41-50
3400,"Cormier, Serge",M,43,1975,2019,44,41-50
3401,"Dong, Han",M,43,1975,2019,44,41-50
3402,"Gerretsen, Mark",M,43,1975,2019,44,41-50
3403,"Jeneroux, Matt",M,43,1975,2019,44,41-50
3404,"Tochor, Corey",M,43,1975,2019,44,41-50
3405,"Guay, Raynald Joseph Albert",M,30,1933,1974,41,41-50
3406,"Jerome, James Alexander",M,30,1933,1974,41,41-50
3407,"Penner, B. Keith",M,30,1933,1974,41,41-50
3408,"Reilly, Peter",M,30,1933,1974,41,41-50
3409,"Schumacher, Stanley Stanford",M,30,1933,1974,41,41-50
3410,"Higson, Kenneth James",M,30,1934,1974,40,31-40
3411,"Blackburn, Derek Nigel Ernest",M,30,1934,1974,40,31-40
3412,"Chrétien, Joseph Jacques Jean",M,30,1934,1974,40,31-40
3413,"Watson, Ian",M,30,1934,1974,40,31-40
3414,"Firth, Walter (Wally)",M,30,1935,1974,39,31-40
3415,"Matte, René",M,30,1935,1974,39,31-40
3416,"Mazankowski, Donald Frank",M,30,1935,1974,39,31-40
3417,"Wise, John",M,30,1935,1974,39,31-40
3418,"Bégin, Monique",F,30,1936,1974,38,31-40
3419,"Blaker, Roderick",M,30,1936,1974,38,31-40
3420,"Broadbent, John Edward",M,30,1936,1974,38,31-40
3421,"Campbell, John",M,30,1936,1974,38,31-40
3422,"Grier, Terrence Wyly",M,30,1936,1974,38,31-40
3423,"Guilbault, Jacques",M,30,1936,1974,38,31-40
3424,"MacDonald, David Samuel Horne",M,30,1936,1974,38,31-40
3425,"MacKay, Elmer MacIntosh",M,30,1936,1974,38,31-40
3426,"Roy, Marcel-Claude",M,30,1936,1974,38,31-40
3427,"Caron, Yves",M,30,1937,1974,37,31-40
3428,"Beatty, Henry Perrin",M,30,1937,1974,37,31-40
3429,"Hueglin, Joseph Fred",M,30,1937,1974,37,31-40
3430,"Reid, John Mercer",M,30,1937,1974,37,31-40
3431,"Rodriguez, John R.",M,30,1937,1974,37,31-40
3432,"Rooney, Richard David (Dave)",M,30,1937,1974,37,31-40
3433,"Demers, Yves",M,30,1938,1974,36,31-40
3434,"Haliburton, Charles E.",M,30,1938,1974,36,31-40
3435,"Stewart, William Douglas",M,30,1938,1974,36,31-40
3436,"Boisvert, Jean-Marie",M,30,1939,1974,35,31-40
3437,"Clark, Charles Joseph",M,30,1939,1974,35,31-40
3438,"Epp, Arthur Jacob (Jake)",M,30,1939,1974,35,31-40
3439,"Fleming, James Sydney Clark",M,30,1939,1974,35,31-40
3440,"Althouse, Victor Fredrich (Vic)",M,32,1937,1980,43,41-50
3441,"Beatty, Henry Perrin",M,32,1937,1980,43,41-50
3442,"Deans, Ian",M,32,1937,1980,43,41-50
3443,"Malone, Arnold John",M,32,1937,1980,43,41-50
3444,"Reid, John Mercer",M,32,1937,1980,43,41-50
3445,"Rooney, Richard David (Dave)",M,32,1937,1980,43,41-50
3446,"Tousignant, Henri",M,32,1937,1980,43,41-50
3447,"Wilson, Michael Holcombe",M,32,1937,1980,43,41-50
3448,"Lundrigan, John Howard",M,30,1939,1974,35,31-40
3449,"Epp, Abram Ernest",M,33,1941,1984,43,41-50
3450,"Gurbin, Gary Michael",M,33,1941,1984,43,41-50
3451,"Harvey, André",M,33,1941,1984,43,41-50
3452,"Hudon, Jean-Guy",M,33,1941,1984,43,41-50
3453,"Kilgour, David",M,33,1941,1984,43,41-50
3454,"Leblanc, Nic",M,33,1941,1984,43,41-50
3455,"Siddon, Thomas Edward",M,33,1941,1984,43,41-50
3456,"Skelly, Raymond John",M,33,1941,1984,43,41-50
3457,"Speyer, Chris",M,33,1941,1984,43,41-50
3458,"Thacker, Blaine Allen",M,33,1941,1984,43,41-50
3459,"Wilson, Geoff",M,33,1941,1984,43,41-50
3460,"Boyer, Patrick",M,34,1945,1988,43,41-50
3461,"Dobbie, Dorothy I.",F,34,1945,1988,43,41-50
3462,"Greene, Barbara",F,34,1945,1988,43,41-50
3463,"Rideout, George Saunders",M,34,1945,1988,43,41-50
3464,"Venne, Pierrette",F,34,1945,1988,43,41-50
3465,"Young, Neil",M,33,1945,1984,39,31-40
3466,"Anawak, Jack Iyerak",M,35,1950,1993,43,41-50
3467,"Asselin, Gérard",M,35,1950,1993,43,41-50
3468,"Benoit, Leon Earl",M,35,1950,1993,43,41-50
3469,"Berger, David",M,35,1950,1993,43,41-50
3470,"Campbell, Barry R.",M,35,1950,1993,43,41-50
3471,"Fontana, Joseph Frank (Joe)",M,35,1950,1993,43,41-50
3472,"Gauthier, Michel",M,35,1950,1993,43,41-50
3473,"Manley, John Paul",M,35,1950,1993,43,41-50
3474,"McLellan, A. Anne",F,35,1950,1993,43,41-50
3475,"Solomon, John Lewis",M,35,1950,1993,43,41-50
3476,"St. Denis, Brent",M,35,1950,1993,43,41-50
3477,"Wappel, Thomas (Tom) William",M,35,1950,1993,43,41-50
3478,"Bakopanos, Eleni",F,36,1954,1997,43,41-50
3479,"Kerpan, Allan Edward Joseph",M,36,1954,1997,43,41-50
3480,"Lowther, Eric",M,36,1954,1997,43,41-50
3481,"Scott, Michael G.",M,36,1954,1997,43,41-50
3482,"Anderson, David",M,37,1957,2000,43,41-50
3483,"Anderson, David",M,37,1957,2000,43,41-50
3484,"Anderson, David",M,37,1957,2000,43,41-50
3485,"Anderson, David",M,37,1957,2000,43,41-50
3486,"Farrah, Georges",M,37,1957,2000,43,41-50
3487,"Grewal, Gurmant Singh",M,37,1957,2000,43,41-50
3488,"Ianno, Tony",M,37,1957,2000,43,41-50
3489,"Karetak-Lindell, Nancy",F,37,1957,2000,43,41-50
3490,"Laframboise, Mario",M,37,1957,2000,43,41-50
3491,"Lunn, Gary",M,37,1957,2000,43,41-50
3492,"Strahl, Charles (Chuck)",M,37,1957,2000,43,41-50
3493,"Tirabassi, Anthony (Tony)",M,37,1957,2000,43,41-50
3494,"Valeri, Tony",M,37,1957,2000,43,41-50
3495,"Kotto, Maka",M,38,1961,2004,43,41-50
3496,"Rota, Anthony",M,38,1961,2004,43,41-50
3497,"Bernier, Maxime",M,39,1963,2006,43,41-50
3498,"Charlton, Chris",F,39,1963,2006,43,41-50
3499,"Coderre, Denis",M,39,1963,2006,43,41-50
3500,"DeBellefeuille, Claude",F,39,1963,2006,43,41-50
3501,"Devolin, Barry",M,39,1963,2006,43,41-50
3502,"Dewar, Paul",M,39,1963,2006,43,41-50
3503,"Jean, Brian",M,39,1963,2006,43,41-50
3504,"Lemieux, Pierre",M,39,1963,2006,43,41-50
3505,"Sauvageau, Benoît",M,39,1963,2006,43,41-50
3506,"Van Loan, Peter",M,38,1963,2004,41,41-50
3507,"Van Loan, Peter",M,39,1963,2006,43,41-50
3508,"Allison, Dean",M,40,1965,2008,43,41-50
3509,"Bezan, James",M,40,1965,2008,43,41-50
3510,"Blaney, Steven",M,40,1965,2008,43,41-50
3511,"MacKay, Peter Gordon",M,40,1965,2008,43,41-50
3512,"Alexander, Chris",M,41,1968,2011,43,41-50
3513,"Brahmi, Tarik",M,41,1968,2011,43,41-50
3514,"Calkins, Blaine",M,41,1968,2011,43,41-50
3515,"Caron, Guy",M,41,1968,2011,43,41-50
3516,"Freeland, Chrystia",F,41,1968,2011,43,41-50
3517,"Jones, Yvonne",F,41,1968,2011,43,41-50
3518,"Kenney, Jason",M,41,1968,2011,43,41-50
3519,"Masse, Brian",M,41,1968,2011,43,41-50
3520,"Raitt, Lisa",F,41,1968,2011,43,41-50
3521,"Cullen, Nathan",M,42,1972,2015,43,41-50
3522,"Albas, Dan",M,43,1976,2019,43,41-50
3523,"Lobb, Ben",M,43,1976,2019,43,41-50
3524,"Sahota, Jag",F,43,1976,2019,43,41-50
3525,"Ouellet, André",M,30,1939,1974,35,31-40
3526,"Corbett, Robert Alfred",M,32,1938,1980,42,41-50
3527,"Gagliano, Alfonso",M,33,1942,1984,42,41-50
3528,"Pelletier, Irénée",M,30,1939,1974,35,31-40
3529,"Andre, Harvie",M,30,1940,1974,34,31-40
3530,"Blais, Jean-Jacques",M,30,1940,1974,34,31-40
3531,"Caouette, Gilles",M,30,1940,1974,34,31-40
3532,"Dick, Paul Wyatt",M,30,1940,1974,34,31-40
3533,"Jelinek, Otto John",M,30,1940,1974,34,31-40
3534,"O'Connor, Terrance Patrick (Terry)",M,30,1940,1974,34,31-40
3535,"Rowland, Douglas Charles",M,30,1940,1974,34,31-40
3536,"Atkey, Ronald George",M,30,1942,1974,32,31-40
3537,"Dupont, Raymond",M,30,1942,1974,32,31-40
3538,"Reynolds, John Douglas",M,30,1942,1974,32,31-40
3539,"Fortin, André-Gilles",M,30,1943,1974,31,31-40
3540,"Murta, Jack Burnett",M,30,1943,1974,31,31-40
3541,"Symes, Reginald Cyril",M,30,1943,1974,31,31-40
3542,"Breau, Herb",M,30,1944,1974,30,18-30
3543,"Olivier, Joseph Mario Jacques",M,30,1944,1974,30,18-30
3544,"Nystrom, Lorne Edmund",M,30,1946,1974,28,18-30
3545,"Knight, William George",M,30,1947,1974,27,18-30
3546,"Schellenberger, Stanley Kenneth",M,30,1948,1974,26,18-30
3547,"O'Sullivan, Sean Patrick",M,30,1952,1974,22,18-30
3548,"Diefenbaker, John George",M,31,1895,1979,84,71+
3549,"Rynard, Philip Bernard",M,31,1897,1979,82,71+
3550,"Michener, Daniel Roland",M,31,1900,1979,79,71+
3551,"Douglas, Thomas Clement (Tommy)",M,31,1904,1979,75,71+
3552,"MacDonald, Flora Isabel",F,31,1904,1979,75,71+
3553,"MacInnis, Winona Grace",F,31,1905,1979,74,71+
3554,"Railton, Samuel Victor",M,31,1906,1979,73,71+
3555,"Baldwin, Gerald William",M,31,1907,1979,72,71+
3556,"Brewin, Francis Andrew",M,31,1907,1979,72,71+
3557,"Dionne, Charles-Eugène",M,31,1908,1979,71,71+
3558,"Bradley, T.A. Bud",M,32,1938,1980,42,41-50
3559,"Demers, Yves",M,32,1938,1980,42,41-50
3560,"Dion, Rolland",M,32,1938,1980,42,41-50
3561,"Gass, Melbourne Alexander",M,32,1938,1980,42,41-50
3562,"Gingras, René",M,32,1938,1980,42,41-50
3563,"Harquail, Maurice James",M,32,1938,1980,42,41-50
3564,"Lewis, Douglas Grinslade",M,32,1938,1980,42,41-50
3565,"Malépart, Jean-Claude",M,32,1938,1980,42,41-50
3566,"Scott, Geoffrey Douglas",M,32,1938,1980,42,41-50
3567,"Côté, Michel",M,33,1942,1984,42,41-50
3568,"de Jong, Simon Leendert",M,33,1942,1984,42,41-50
3569,"Ferland, Marc",M,33,1942,1984,42,41-50
3570,"Jepson, James Kenneth (Jim)",M,33,1942,1984,42,41-50
3571,"McCrossan, William Paul Joseph",M,33,1942,1984,42,41-50
3572,"Ricard, Guy",M,33,1942,1984,42,41-50
3573,"Riis, Nelson Andrew",M,33,1942,1984,42,41-50
3574,"Waddell, Ian Gardiner",M,33,1942,1984,42,41-50
3575,"Gray, Darryl L.",M,34,1946,1988,42,41-50
3576,"Langdon, Steven W.",M,34,1946,1988,42,41-50
3577,"MacAulay, Lawrence",M,34,1946,1988,42,41-50
3578,"Milliken, Peter Andrew Stewart",M,34,1946,1988,42,41-50
3579,"Mills, Dennis Joseph",M,34,1946,1988,42,41-50
3580,"Murphy, Rodney Edward",M,34,1946,1988,42,41-50
3581,"Nystrom, Lorne Edmund",M,34,1946,1988,42,41-50
3582,"Witer, Andrew",M,33,1946,1984,38,31-40
3583,"Bachand, Claude",M,35,1951,1993,42,41-50
3584,"Blaikie, William Alexander (Bill)",M,35,1951,1993,42,41-50
3585,"Blondin-Andrew, Ethel Dorothy",F,35,1951,1993,42,41-50
3586,"Calder, Murray",M,35,1951,1993,42,41-50
3587,"Cannis, John",M,35,1951,1993,42,41-50
3588,"Chan, Raymond",M,35,1951,1993,42,41-50
3589,"Murray, Ian",M,35,1951,1993,42,41-50
3590,"O'Brien, Lawrence D.",M,35,1951,1993,42,41-50
3591,"Pettigrew, Pierre Stewart",M,35,1951,1993,42,41-50
3592,"Serré, Benoît",M,35,1951,1993,42,41-50
3593,"Bélanger, Mauril",M,36,1955,1997,42,41-50
3594,"Desjarlais, Bev",F,36,1955,1997,42,41-50
3595,"Dion, Stéphane",M,36,1955,1997,42,41-50
3596,"Godin, Yvon",M,36,1955,1997,42,41-50
3597,"Hart, James (Jim) Alexander",M,36,1955,1997,42,41-50
3598,"Karygiannis, Jim",M,36,1955,1997,42,41-50
3599,"Martin, Pat",M,36,1955,1997,42,41-50
3600,"Nault, Robert Daniel",M,36,1955,1997,42,41-50
3601,"Nunziata, John V.",M,36,1955,1997,42,41-50
3602,"Pratt, David",M,36,1955,1997,42,41-50
3603,"Scott, Andy",M,36,1955,1997,42,41-50
3604,"Stewart, Jane",F,36,1955,1997,42,41-50
3605,"Turp, Daniel",M,36,1955,1997,42,41-50
3606,"Vellacott, Maurice",M,36,1955,1997,42,41-50
3607,"Jordan, Joe Louis",M,37,1958,2000,42,41-50
3608,"Laliberte, Rick",M,37,1958,2000,42,41-50
3609,"Simard, Raymond",M,37,1958,2000,42,41-50
3610,"Solberg, Monte",M,37,1958,2000,42,41-50
3611,"Sorenson, Kevin",M,37,1958,2000,42,41-50
3612,"Angus, Charlie",M,38,1962,2004,42,41-50
3613,"Carrie, Colin",M,38,1962,2004,42,41-50
3614,"Julian, Peter",M,38,1962,2004,42,41-50
3615,"McTeague, Dan",M,38,1962,2004,42,41-50
3616,"Ménard, Réal",M,38,1962,2004,42,41-50
3617,"Pacetti, Massimo",M,38,1962,2004,42,41-50
3618,"Torsney, Paddy",F,38,1962,2004,42,41-50
3619,"Bellavance, André",M,39,1964,2006,42,41-50
3620,"Gourde, Jacques",M,39,1964,2006,42,41-50
3621,"Harvey, Luc",M,39,1964,2006,42,41-50
3622,"Merasty, Gary",M,39,1964,2006,42,41-50
3623,"Reid, Scott",M,39,1964,2006,42,41-50
3624,"Armstrong, Scott",M,40,1966,2008,42,41-50
3625,"Byrne, Gerry",M,40,1966,2008,42,41-50
3626,"Donnelly, Fin",M,40,1966,2008,42,41-50
3627,"Duncan, Kirsty",F,40,1966,2008,42,41-50
3628,"Dykstra, Richard",M,40,1966,2008,42,41-50
3629,"Russell, Todd Norman",M,40,1966,2008,42,41-50
3630,"Silva, Mario",M,40,1966,2008,42,41-50
3631,"Ambrose, Rona",F,41,1969,2011,42,41-50
3632,"Baird, John",M,41,1969,2011,42,41-50
3633,"Hiebert, Russ",M,41,1969,2011,42,41-50
3634,"Lake, Mike",M,41,1969,2011,42,41-50
3635,"Mourani, Maria",F,41,1969,2011,42,41-50
3636,"Simms, Scott",M,41,1969,2011,42,41-50
3637,"Thibeault, Glenn",M,41,1969,2011,42,41-50
3638,"Boulerice, Alexandre",M,42,1973,2015,42,41-50
3639,"Housefather, Anthony",M,42,1973,2015,42,41-50
3640,"MacGregor, Alistair",M,42,1973,2015,42,41-50
3641,"Mendicino, Marco",M,42,1973,2015,42,41-50
3642,"Miller, Marc",M,42,1973,2015,42,41-50
3643,"O'Toole, Erin",M,42,1973,2015,42,41-50
3644,"Bains, Navdeep Singh",M,43,1977,2019,42,41-50
3645,"Baker, Yvan",M,43,1977,2019,42,41-50
3646,"Battiste, Jaime",M,43,1977,2019,42,41-50
3647,"Gaudreau, Marie-Hélène",F,43,1977,2019,42,41-50
3648,"Gill, Marilène",F,43,1977,2019,42,41-50
3649,"Mathyssen, Lindsay",F,43,1977,2019,42,41-50
3650,"Turnbull, Ryan",M,43,1977,2019,42,41-50
3651,"Knowles, Stanley Howard",M,31,1908,1979,71,71+
3652,"Knowles, William David",M,31,1908,1979,71,71+
3653,"Tétrault, Oza",M,31,1908,1979,71,71+
3654,"Hales, Alfred Dryden",M,31,1909,1979,70,61-70
3655,"Barnett, Thomas Speakman",M,31,1909,1979,70,61-70
3656,"Duquet, Gérard",M,31,1909,1979,70,61-70
3657,"Lewis, David",M,31,1909,1979,70,61-70
3658,"Mather, Barry",M,31,1909,1979,70,61-70
3659,"Hees, George Harris",M,31,1910,1979,69,61-70
3660,"Darling, Stan",M,31,1911,1979,68,61-70
3661,"Gleave, Alfred Pullen",M,31,1911,1979,68,61-70
3662,"Patterson, Alexander Bell",M,31,1911,1979,68,61-70
3663,"Sharp, Mitchell William",M,31,1911,1979,68,61-70
3664,"Walker, James Edgar",M,31,1911,1979,68,61-70
3665,"Alkenbrack, Almonte Douglas",M,31,1912,1979,67,61-70
3666,"Blouin, Gustave",M,31,1912,1979,67,61-70
3667,"Drury, Charles Mills (Bud)",M,31,1912,1979,67,61-70
3668,"Hamilton, Francis Alvin George",M,31,1912,1979,67,61-70
3669,"Smith, Walter Bernard",M,31,1912,1979,67,61-70
3670,"Thomas, J. Antonio",M,31,1912,1979,67,61-70
3671,"Clermont, Gaston",M,31,1913,1979,66,61-70
3672,"Latulippe, Henry P.",M,31,1913,1979,66,61-70
3673,"Gauthier, Charles-Arthur",M,31,1913,1979,66,61-70
3674,"Hymmen, Kieth Reinhardt",M,31,1913,1979,66,61-70
3675,"Lambert, Joseph Adrien Henri",M,31,1913,1979,66,61-70
3676,"Harding, Randolph",M,31,1914,1979,65,61-70
3677,"L'Heureux, Yvon",M,31,1914,1979,65,61-70
3678,"Axworthy, Lloyd",M,32,1939,1980,41,41-50
3679,"Bussières, Pierre",M,32,1939,1980,41,41-50
3680,"Clark, Charles Joseph",M,32,1939,1980,41,41-50
3681,"Duclos, Louis",M,32,1939,1980,41,41-50
3682,"Epp, Arthur Jacob (Jake)",M,32,1939,1980,41,41-50
3683,"Fleming, James Sydney Clark",M,32,1939,1980,41,41-50
3684,"Kristiansen, Lyle Stuart",M,32,1939,1980,41,41-50
3685,"Lapointe, Normand",M,32,1939,1980,41,41-50
3686,"Lumley, Edward C.",M,32,1939,1980,41,41-50
3687,"Mulroney, Martin Brian",M,32,1939,1980,41,41-50
3688,"Ouellet, André",M,32,1939,1980,41,41-50
3689,"Pelletier, Irénée",M,32,1939,1980,41,41-50
3690,"Simmons, Roger",M,32,1939,1980,41,41-50
3691,"Veillette, Michel",M,32,1939,1980,41,41-50
3692,"Caldwell, James Eber",M,33,1943,1984,41,41-50
3693,"Danis, Marcel",M,33,1943,1984,41,41-50
3694,"Della Noce, Vincent",M,33,1943,1984,41,41-50
3695,"Grondin, Gilles",M,33,1943,1984,41,41-50
3696,"Keeper, Cyril",M,33,1943,1984,41,41-50
3697,"Murta, Jack Burnett",M,33,1943,1984,41,41-50
3698,"Plamondon, Louis",M,33,1943,1984,41,41-50
3699,"Tremblay, Marcel R.",M,33,1943,1984,41,41-50
3700,"Vankoughnet, William John",M,33,1943,1984,41,41-50
3701,"Warner, Norman Melvin",M,33,1943,1984,41,41-50
3702,"Angus, Iain Francis",M,34,1947,1988,41,41-50
3703,"Atkinson, Kenneth David",M,34,1947,1988,41,41-50
3704,"Axworthy, Chris",M,34,1947,1988,41,41-50
3705,"Bjornson, David",M,34,1947,1988,41,41-50
3706,"Bosley, John William",M,34,1947,1988,41,41-50
3707,"Campbell, A. Kim",F,34,1947,1988,41,41-50
3708,"Duceppe, Gilles",M,34,1947,1988,41,41-50
3709,"Hunter, Lynn",F,34,1947,1988,41,41-50
3710,"MacDougall, John Alexander Frances",M,34,1947,1988,41,41-50
3711,"Richardson, Lee",M,34,1947,1988,41,41-50
3712,"Thompson, Gregory Francis",M,34,1947,1988,41,41-50
3713,"Volpe, Giuseppe (Joseph)",M,34,1947,1988,41,41-50
3714,"Walker, David",M,34,1947,1988,41,41-50
3715,"Arseneault, Guy H.",M,35,1952,1993,41,41-50
3716,"Barnes, Susan (Sue)",F,35,1952,1993,41,41-50
3717,"Chamberlain, Brenda",F,35,1952,1993,41,41-50
3718,"Copps, Sheila Maureen",F,35,1952,1993,41,41-50
3719,"Daviault, Michel",M,35,1952,1993,41,41-50
3720,"Dhaliwal, Harbance Singh (Herb)",M,35,1952,1993,41,41-50
3721,"Dingwall, David Charles",M,35,1952,1993,41,41-50
3722,"Grey, Deborah C.",F,35,1952,1993,41,41-50
3723,"Hermanson, Elwin Norris",M,35,1952,1993,41,41-50
3724,"Hill, Jay D.",M,35,1952,1993,41,41-50
3725,"Kraft Sloan, Karen",F,35,1952,1993,41,41-50
3726,"Robinson, Svend Johannes",M,35,1952,1993,41,41-50
3727,"Sheridan, Georgette",F,35,1952,1993,41,41-50
3728,"Taylor, Leonard William (Len)",M,35,1952,1993,41,41-50
3729,"Drouin, Claude",M,36,1956,1997,41,41-50
3730,"Iftody, David",M,36,1956,1997,41,41-50
3731,"Knutson, Gar",M,36,1956,1997,41,41-50
3732,"Limoges, Richard G.J.",M,36,1956,1997,41,41-50
3733,"Mancini, Peter",M,36,1956,1997,41,41-50
3734,"Marchi, Sergio",M,36,1956,1997,41,41-50
3735,"Mitchell, Andrew (Andy)",M,36,1956,1997,41,41-50
3736,"Speller, Robert (Bob)",M,36,1956,1997,41,41-50
3737,"Stoffer, Peter",M,36,1956,1997,41,41-50
3738,"Zed, Paul",M,35,1956,1993,37,31-40
3739,"Barnes, Rex",M,37,1959,2000,41,41-50
3740,"Guay, Monique",F,37,1959,2000,41,41-50
3741,"Harper, Stephen",M,37,1959,2000,41,41-50
3742,"Loubier, Yvan",M,37,1959,2000,41,41-50
3743,"Regan, Geoff",M,37,1959,2000,41,41-50
3744,"Thibault, Robert",M,37,1959,2000,41,41-50
3745,"Coderre, Denis",M,38,1963,2004,41,41-50
3746,"Devolin, Barry",M,38,1963,2004,41,41-50
3747,"Jean, Brian",M,38,1963,2004,41,41-50
3748,"Sauvageau, Benoît",M,38,1963,2004,41,41-50
3749,"Savoy, Andy",M,38,1963,2004,41,41-50
3750,"Smith, David",M,38,1963,2004,41,41-50
3751,"Whelan, Susan",F,37,1963,2000,37,31-40
3752,"Allison, Dean",M,39,1965,2006,41,41-50
3753,"Bezan, James",M,39,1965,2006,41,41-50
3754,"Blaney, Steven",M,39,1965,2006,41,41-50
3755,"MacKay, Peter Gordon",M,39,1965,2006,41,41-50
3756,"Aglukkaq, Leona",F,40,1967,2008,41,41-50
3757,"Brison, Scott",M,40,1967,2008,41,41-50
3758,"Clarke, Rob",M,40,1967,2008,41,41-50
3759,"Glover, Shelly",F,40,1967,2008,41,41-50
3760,"Hoback, Randy",M,40,1967,2008,41,41-50
3761,"Kania, Andrew J.",M,40,1967,2008,41,41-50
3762,"LeBlanc, Dominic",M,40,1967,2008,41,41-50
3763,"Rickford, Greg",M,40,1967,2008,41,41-50
3764,"Rodriguez, Pablo",M,40,1967,2008,41,41-50
3765,"Calandra, Paul",M,41,1970,2011,41,41-50
3766,"Chicoine, Sylvain",M,41,1970,2011,41,41-50
3767,"Del Mastro, Dean",M,41,1970,2011,41,41-50
3768,"Leitch, K. Kellie",F,41,1970,2011,41,41-50
3769,"Rajotte, James",M,41,1970,2011,41,41-50
3770,"Seeback, Kyle",M,41,1970,2011,41,41-50
3771,"Amos, William",M,42,1974,2015,41,41-50
3772,"Boudrias, Michel",M,42,1974,2015,41,41-50
3773,"Caesar-Chavannes, Celina",F,42,1974,2015,41,41-50
3774,"Hillyer, Jim",M,42,1974,2015,41,41-50
3775,"Holland, Mark",M,42,1974,2015,41,41-50
3776,"Lockhart, Alaina",F,42,1974,2015,41,41-50
3777,"May, Bryan",M,42,1974,2015,41,41-50
3778,"Richards, Blake",M,42,1974,2015,41,41-50
3779,"Romanado, Sherry",F,42,1974,2015,41,41-50
3780,"Trost, Brad",M,42,1974,2015,41,41-50
3781,"Blaikie, Daniel",M,43,1978,2019,41,41-50
3782,"Kram, Michael",M,43,1978,2019,41,41-50
3783,"Kusmierczyk, Irek",M,43,1978,2019,41,41-50
3784,"Rood, Lianne",F,43,1978,2019,41,41-50
3785,"Strahl, Mark",M,43,1978,2019,41,41-50
3786,"Warkentin, Chris",M,42,1978,2015,37,31-40
3787,"Warkentin, Chris",M,43,1978,2019,41,41-50
3788,"Zuberi, Sameer",M,43,1978,2019,41,41-50
3789,"MacLean, John Angus",M,31,1914,1979,65,61-70
3790,"Stanfield, Robert Lorne",M,31,1914,1979,65,61-70
3791,"Allard, Eudore",M,31,1915,1979,64,61-70
3792,"Madill, John Ellwood",M,31,1915,1979,64,61-70
3793,"Danforth, Harold Warren",M,31,1916,1979,63,61-70
3794,"Davis, John (Jack)",M,31,1916,1979,63,61-70
3795,"Dinsdale, Walter Gilbert",M,31,1916,1979,63,61-70
3796,"Munro, Donald W.",M,31,1916,1979,63,61-70
3797,"Thomas, Charles Humbert",M,31,1916,1979,63,61-70
3798,"Woolliams, Eldon Mattison",M,31,1916,1979,63,61-70
3799,"Caouette, David Réal",M,31,1917,1979,62,61-70
3800,"Hargrave, Herbert Thomas (Bert)",M,31,1917,1979,62,61-70
3801,"McCain, Fred Alward",M,31,1917,1979,62,61-70
3802,"McKinnon, Allan Bruce",M,31,1917,1979,62,61-70
3803,"Nelson, Nels Edwin",M,31,1917,1979,62,61-70
3804,"Boulanger, Prosper",M,31,1918,1979,61,61-70
3805,"Crouse, Lloyd Roseville",M,31,1918,1979,61,61-70
3806,"MacDonald, Daniel Joseph",M,31,1918,1979,61,61-70
3807,"MacInnis, Donald",M,31,1918,1979,61,61-70
3808,"Nesbitt, Wallace Bickford (Wally)",M,31,1918,1979,61,61-70
3809,"Orlikow, David",M,31,1918,1979,61,61-70
3810,"Ritchie, William Gordon",M,31,1918,1979,61,61-70
3811,"Whicher, Ross Mackenzie",M,31,1918,1979,61,61-70
3812,"Lambert, Marcel Joseph Aimé",M,31,1919,1979,60,51-60
3813,"Mitges, Constantine George (Gus)",M,31,1919,1979,60,51-60
3814,"Pelletier, Gérard",M,31,1919,1979,60,51-60
3815,"Towers, Thomas Gordon",M,31,1919,1979,60,51-60
3816,"Andre, Harvie",M,32,1940,1980,40,31-40
3817,"Blais, Jean-Jacques",M,32,1940,1980,40,31-40
3818,"Campbell, Coline M.",F,32,1940,1980,40,31-40
3819,"Daudlin, Robert Mose Patrick",M,32,1940,1980,40,31-40
3820,"Dick, Paul Wyatt",M,32,1940,1980,40,31-40
3821,"Jelinek, Otto John",M,32,1940,1980,40,31-40
3822,"MacLellan, Russell Gregoire",M,32,1940,1980,40,31-40
3823,"McCauley, Gary Francis",M,32,1940,1980,40,31-40
3824,"McDermid, John Horton",M,32,1940,1980,40,31-40
3825,"McDonald, Lynn",F,32,1940,1980,40,31-40
3826,"McKnight, William Hunter (Bill)",M,32,1940,1980,40,31-40
3827,"Pinard, Yvon",M,32,1940,1980,40,31-40
3828,"Wenman, Robert Lloyd",M,32,1940,1980,40,31-40
3829,"Duguay, Léo",M,33,1944,1984,40,31-40
3830,"Elzinga, Peter",M,33,1944,1984,40,31-40
3831,"Gérin, François",M,33,1944,1984,40,31-40
3832,"Grisé, Richard",M,33,1944,1984,40,31-40
3833,"Holtmann, Felix",M,33,1944,1984,40,31-40
3834,"Moore, Barry D.",M,33,1944,1984,40,31-40
3835,"Nickerson, Dave",M,33,1944,1984,40,31-40
3836,"Tremblay, Maurice",M,33,1944,1984,40,31-40
3837,"Blackburn, Jean-Pierre",M,34,1948,1988,40,31-40
3838,"Blais, Pierre",M,34,1948,1988,40,31-40
3839,"Cadieux, Pierre H.",M,34,1948,1988,40,31-40
3840,"Clancy, Mary Catherine",F,34,1948,1988,40,31-40
3841,"Funk, Raymond John",M,34,1948,1988,40,31-40
3842,"Lee, Derek Vincent",M,34,1948,1988,40,31-40
3843,"Soetens, René John",M,34,1948,1988,40,31-40
3844,"Tremblay, Benoît",M,34,1948,1988,40,31-40
3845,"Bertrand, Robert",M,35,1953,1993,40,31-40
3846,"Crête, Paul",M,35,1953,1993,40,31-40
3847,"Deshaies, Bernard",M,35,1953,1993,40,31-40
3848,"Guarnieri, Albina",F,35,1953,1993,40,31-40
3849,"Guimond, Michel",M,35,1953,1993,40,31-40
3850,"Keyes, Stan Kazmierczak",M,35,1953,1993,40,31-40
3851,"LeBlanc, Francis G.",M,35,1953,1993,40,31-40
3852,"St-Laurent, Bernard",M,35,1953,1993,40,31-40
3853,"Anderson, David",M,36,1957,1997,40,31-40
3854,"Anderson, David",M,36,1957,1997,40,31-40
3855,"Grewal, Gurmant Singh",M,36,1957,1997,40,31-40
3856,"Ianno, Tony",M,36,1957,1997,40,31-40
3857,"Karetak-Lindell, Nancy",F,36,1957,1997,40,31-40
3858,"Lunn, Gary",M,36,1957,1997,40,31-40
3859,"Muise, Mark",M,36,1957,1997,40,31-40
3860,"Strahl, Charles (Chuck)",M,36,1957,1997,40,31-40
3861,"Valeri, Tony",M,36,1957,1997,40,31-40
3862,"Bevilacqua, Maurizio",M,37,1960,2000,40,31-40
3863,"Eyking, Mark",M,37,1960,2000,40,31-40
3864,"Gallant, Cheryl",F,37,1960,2000,40,31-40
3865,"Martin, Keith P.",M,37,1960,2000,40,31-40
3866,"Bellavance, André",M,38,1964,2004,40,31-40
3867,"Reid, Scott",M,38,1964,2004,40,31-40
3868,"Byrne, Gerry",M,39,1966,2006,40,31-40
3869,"Dykstra, Richard",M,39,1966,2006,40,31-40
3870,"Russell, Todd Norman",M,39,1966,2006,40,31-40
3871,"Silva, Mario",M,39,1966,2006,40,31-40
3872,"Stronach, Belinda",F,39,1966,2006,40,31-40
3873,"Calkins, Blaine",M,40,1968,2008,40,31-40
3874,"Kenney, Jason",M,40,1968,2008,40,31-40
3875,"Masse, Brian",M,40,1968,2008,40,31-40
3876,"Raitt, Lisa",F,40,1968,2008,40,31-40
3877,"Barlow, John",M,41,1971,2011,40,31-40
3878,"Chong, Michael D.",M,41,1971,2011,40,31-40
3879,"Lapointe, François",M,41,1971,2011,40,31-40
3880,"Nicholls, Jamie",M,41,1971,2011,40,31-40
3881,"Trudeau, Justin",M,41,1971,2011,40,31-40
3882,"Watson, Jeff",M,40,1971,2008,37,31-40
3883,"Cormier, Serge",M,42,1975,2015,40,31-40
3884,"Gerretsen, Mark",M,42,1975,2015,40,31-40
3885,"Jeneroux, Matt",M,42,1975,2015,40,31-40
3886,"Rusnak, Don",M,42,1975,2015,40,31-40
3887,"Bittle, Chris",M,43,1979,2019,40,31-40
3888,"Brunelle-Duceppe, Alexis",M,43,1979,2019,40,31-40
3889,"Dhillon, Anju",F,43,1979,2019,40,31-40
3890,"Dzerowicz, Julie",F,43,1979,2019,40,31-40
3891,"Joly, Mélanie",F,43,1979,2019,40,31-40
3892,"Lawrence, Philip",M,43,1979,2019,40,31-40
3893,"Poilievre, Pierre",M,43,1979,2019,40,31-40
3894,"Scheer, Andrew",M,43,1979,2019,40,31-40
3895,"Schiefke, Peter",M,43,1979,2019,40,31-40
3896,"Singh, Jagmeet",M,43,1979,2019,40,31-40
3897,"Trudeau, Pierre Elliott",M,31,1919,1979,60,51-60
3898,"Trudel, Jacques L.",M,31,1919,1979,60,51-60
3899,"Whittaker, George H.",M,31,1919,1979,60,51-60
3900,"Gendron, Rosaire",M,31,1920,1979,59,51-60
3901,"Isabelle, Joseph Gaston",M,31,1920,1979,59,51-60
3902,"Lamoureux, Lucien",M,31,1920,1979,59,51-60
3903,"Masniuk, Peter Paul",M,31,1920,1979,59,51-60
3904,"Andras, Robert Knight",M,31,1921,1979,58,51-60
3905,"Danson, Barnett Jerome",M,31,1921,1979,58,51-60
3906,"Gilbert, John",M,31,1921,1979,58,51-60
3907,"Hamilton, Frank Fletcher",M,31,1921,1979,58,51-60
3908,"Jamieson, Donald Campbell",M,31,1921,1979,58,51-60
3909,"Kempling, William James",M,31,1921,1979,58,51-60
3910,"Loiselle, Gérard",M,31,1921,1979,58,51-60
3911,"Mackasey, Bryce Stuart",M,31,1921,1979,58,51-60
3912,"Morin, Albanie",F,31,1921,1979,58,51-60
3913,"Neale, Charles Patrick (Paddy)",M,31,1921,1979,58,51-60
3914,"Saltsman, Max",M,31,1921,1979,58,51-60
3915,"Scott, William C.",M,31,1921,1979,58,51-60
3916,"Smith, G.A. Percy",M,31,1921,1979,58,51-60
3917,"McCleave, Robert Jardine",M,31,1922,1979,57,51-60
3918,"Alexander, Lincoln MacCauley",M,31,1922,1979,57,51-60
3919,"Béchard, Albert",M,31,1922,1979,57,51-60
3920,"Cyr, Alexandre",M,31,1922,1979,57,51-60
3921,"Gillespie, Alastair William",M,31,1922,1979,57,51-60
3922,"Evans, John Leslie",M,32,1941,1980,39,31-40
3923,"Gurbin, Gary Michael",M,32,1941,1980,39,31-40
3924,"Kelly, Norman",M,32,1941,1980,39,31-40
3925,"Kilgour, David",M,32,1941,1980,39,31-40
3926,"Peterson, James Scott (Jim)",M,32,1941,1980,39,31-40
3927,"Siddon, Thomas Edward",M,32,1941,1980,39,31-40
3928,"Skelly, Raymond John",M,32,1941,1980,39,31-40
3929,"Speyer, Chris",M,32,1941,1980,39,31-40
3930,"Thacker, Blaine Allen",M,32,1941,1980,39,31-40
3931,"Bissonnette, André",M,33,1945,1984,39,31-40
3932,"Boyer, Patrick",M,33,1945,1984,39,31-40
3933,"Frith, Douglas Cockburn",M,33,1945,1984,39,31-40
3934,"McMillan, Thomas Michael",M,33,1945,1984,39,31-40
3935,"Price, Joseph",M,33,1945,1984,39,31-40
3936,"Young, Neil",M,32,1945,1980,35,31-40
3937,"Bélair, Réginald",M,34,1949,1988,39,31-40
3938,"Boudria, Don",M,34,1949,1988,39,31-40
3939,"Desjardins, Gabriel",M,34,1949,1988,39,31-40
3940,"MacWilliam, Lyle Dean",M,34,1949,1988,39,31-40
3941,"Stevenson, Kenneth Ross",M,34,1949,1988,39,31-40
3942,"Turner, Garth",M,34,1949,1988,39,31-40
3943,"Bakopanos, Eleni",F,35,1954,1993,39,31-40
3944,"Kerpan, Allan Edward Joseph",M,35,1954,1993,39,31-40
3945,"Scott, Michael G.",M,35,1954,1993,39,31-40
3946,"Skoke, Roseanne",F,35,1954,1993,39,31-40
3947,"Tobin, Brian Vincent",M,35,1954,1993,39,31-40
3948,"Charest, Jean J.",M,36,1958,1997,39,31-40
3949,"Jordan, Joe Louis",M,36,1958,1997,39,31-40
3950,"Laliberte, Rick",M,36,1958,1997,39,31-40
3951,"Solberg, Monte",M,36,1958,1997,39,31-40
3952,"Allison, Dean",M,38,1965,2004,39,31-40
3953,"Bergeron, Stéphane",M,38,1965,2004,39,31-40
3954,"Bezan, James",M,38,1965,2004,39,31-40
3955,"Côté, Guy",M,38,1965,2004,39,31-40
3956,"MacKay, Peter Gordon",M,38,1965,2004,39,31-40
3957,"Brison, Scott",M,39,1967,2006,39,31-40
3958,"Clarke, Rob",M,39,1967,2006,39,31-40
3959,"LeBlanc, Dominic",M,39,1967,2006,39,31-40
3960,"Rodriguez, Pablo",M,39,1967,2006,39,31-40
3961,"Ambrose, Rona",F,40,1969,2008,39,31-40
3962,"Baird, John",M,40,1969,2008,39,31-40
3963,"Bigras, Bernard",M,40,1969,2008,39,31-40
3964,"Guergis, Helena",F,40,1969,2008,39,31-40
3965,"Hiebert, Russ",M,40,1969,2008,39,31-40
3966,"Lake, Mike",M,40,1969,2008,39,31-40
3967,"Mourani, Maria",F,40,1969,2008,39,31-40
3968,"Simms, Scott",M,40,1969,2008,39,31-40
3969,"Thibeault, Glenn",M,40,1969,2008,39,31-40
3970,"Anders, Rob",M,41,1972,2011,39,31-40
3971,"Cullen, Nathan",M,41,1972,2011,39,31-40
3972,"Fletcher, Steven John",M,41,1972,2011,39,31-40
3973,"Larose, Jean-François",M,41,1972,2011,39,31-40
3974,"Albas, Dan",M,42,1976,2015,39,31-40
3975,"Lobb, Ben",M,42,1976,2015,39,31-40
3976,"Bendayan, Rachel",F,43,1980,2019,39,31-40
3977,"Chagger, Bardish",F,43,1980,2019,39,31-40
3978,"Chen, Shaun",M,43,1980,2019,39,31-40
3979,"Green, Matthew",M,43,1980,2019,39,31-40
3980,"Harder, Rachael",F,43,1980,2019,39,31-40
3981,"Rempel Garner, Michelle",F,43,1980,2019,39,31-40
3982,"Sahota, Ruby",F,43,1980,2019,39,31-40
3983,"Herbert, Harold Thomas",M,31,1922,1979,57,51-60
3984,"Peters, William Arnold",M,31,1922,1979,57,51-60
3985,"Richardson, James Armstrong",M,31,1922,1979,57,51-60
3986,"Sauvé, Jeanne",F,31,1922,1979,57,51-60
3987,"Skoreyko, William",M,31,1922,1979,57,51-60
3988,"Yanakis, Antonio",M,31,1922,1979,57,51-60
3989,"Bell, Thomas Miller",M,31,1923,1979,56,51-60
3990,"Dupras, Maurice",M,31,1923,1979,56,51-60
3991,"Fairweather, Robert Gordon Lee",M,31,1923,1979,56,51-60
3992,"Frank, William Charles",M,31,1923,1979,56,51-60
3993,"Hellyer, Paul Theodore",M,31,1923,1979,56,51-60
3994,"Morgan, J. Trevor",M,31,1923,1979,56,51-60
3995,"Roy, Jean Robert",M,31,1923,1979,56,51-60
3996,"Arrol, Ian MacLachlan",M,31,1924,1979,55,51-60
3997,"Beaudoin, Léonel",M,31,1924,1979,55,51-60
3998,"Gillies, James McPhail",M,31,1924,1979,55,51-60
3999,"Laniel, Gérald",M,31,1924,1979,55,51-60
4000,"McKenzie, A. Daniel",M,31,1924,1979,55,51-60
4001,"McRae, Paul Edmund",M,31,1924,1979,55,51-60
4002,"Neil, Douglas Charles",M,31,1924,1979,55,51-60
4003,"Nielsen, Erik",M,31,1924,1979,55,51-60
4004,"Rose, Mark Willson",M,31,1924,1979,55,51-60
4005,"de Jong, Simon Leendert",M,32,1942,1980,38,31-40
4006,"Dupont, Raymond",M,32,1942,1980,38,31-40
4007,"Fisher, Douglas Glenn",M,32,1942,1980,38,31-40
4008,"Miller, Edward Allan",M,32,1942,1980,38,31-40
4009,"Riis, Nelson Andrew",M,32,1942,1980,38,31-40
4010,"Waddell, Ian Gardiner",M,32,1942,1980,38,31-40
4011,"Blouin, Anne",F,33,1946,1984,38,31-40
4012,"Gray, Darryl L.",M,33,1946,1984,38,31-40
4013,"Langdon, Steven W.",M,33,1946,1984,38,31-40
4014,"Murphy, Rodney Edward",M,33,1946,1984,38,31-40
4015,"Nystrom, Lorne Edmund",M,33,1946,1984,38,31-40
4016,"Parry, John Edmund",M,33,1946,1984,38,31-40
4017,"Tardif, Alain",M,33,1946,1984,38,31-40
4018,"Anawak, Jack Iyerak",M,34,1950,1988,38,31-40
4019,"Berger, David",M,34,1950,1988,38,31-40
4020,"Bourgault, Lise",F,34,1950,1988,38,31-40
4021,"Fontana, Joseph Frank (Joe)",M,34,1950,1988,38,31-40
4022,"Fulton, James Ross",M,34,1950,1988,38,31-40
4023,"Gibeau, Marie",F,34,1950,1988,38,31-40
4024,"Johnson, Alan Arthur",M,34,1950,1988,38,31-40
4025,"Manley, John Paul",M,34,1950,1988,38,31-40
4026,"Wappel, Thomas (Tom) William",M,34,1950,1988,38,31-40
4027,"Bélanger, Mauril",M,35,1955,1993,38,31-40
4028,"Dion, Stéphane",M,35,1955,1993,38,31-40
4029,"Hart, James (Jim) Alexander",M,35,1955,1993,38,31-40
4030,"Hickey, Patricia (Bonnie)",F,35,1955,1993,38,31-40
4031,"Karygiannis, Jim",M,35,1955,1993,38,31-40
4032,"MacDonald, Ronald",M,35,1955,1993,38,31-40
4033,"Nault, Robert Daniel",M,35,1955,1993,38,31-40
4034,"Nunziata, John V.",M,35,1955,1993,38,31-40
4035,"Scott, Andy",M,35,1955,1993,38,31-40
4036,"Stewart, Jane",F,35,1955,1993,38,31-40
4037,"Dockrill, Michelle",F,36,1959,1997,38,31-40
4038,"Guay, Monique",F,36,1959,1997,38,31-40
4039,"Hardy, Louise",F,36,1959,1997,38,31-40
4040,"Loubier, Yvan",M,36,1959,1997,38,31-40
4041,"Cauchon, Martin",M,37,1962,2000,38,31-40
4042,"McNally, Grant",M,37,1962,2000,38,31-40
4043,"McTeague, Dan",M,37,1962,2000,38,31-40
4044,"Ménard, Réal",M,37,1962,2000,38,31-40
4045,"Pacetti, Massimo",M,37,1962,2000,38,31-40
4046,"Torsney, Paddy",F,37,1962,2000,38,31-40
4047,"Byrne, Gerry",M,38,1966,2004,38,31-40
4048,"Russell, Todd Norman",M,38,1966,2004,38,31-40
4049,"Silva, Mario",M,38,1966,2004,38,31-40
4050,"Stronach, Belinda",F,38,1966,2004,38,31-40
4051,"Calkins, Blaine",M,39,1968,2006,38,31-40
4052,"Kenney, Jason",M,39,1968,2006,38,31-40
4053,"Masse, Brian",M,39,1968,2006,38,31-40
4054,"Calandra, Paul",M,40,1970,2008,38,31-40
4055,"Del Mastro, Dean",M,40,1970,2008,38,31-40
4056,"Rajotte, James",M,40,1970,2008,38,31-40
4057,"Boulerice, Alexandre",M,41,1973,2011,38,31-40
4058,"Bruinooge, Rod",M,41,1973,2011,38,31-40
4059,"Fortin, Jean-François",M,41,1973,2011,38,31-40
4060,"Leef, Ryan",M,41,1973,2011,38,31-40
4061,"Leslie, Megan",F,41,1973,2011,38,31-40
4062,"Mai, Hoang",M,41,1973,2011,38,31-40
4063,"O'Toole, Erin",M,41,1973,2011,38,31-40
4064,"Ravignat, Mathieu",M,41,1973,2011,38,31-40
4065,"Bains, Navdeep Singh",M,42,1977,2015,38,31-40
4066,"Gill, Marilène",F,42,1977,2015,38,31-40
4067,"Oliver, John",M,42,1977,2015,38,31-40
4068,"Beech, Terry",M,43,1981,2019,38,31-40
4069,"Fragiskatos, Peter",M,43,1981,2019,38,31-40
4070,"Steinley, Warren",M,43,1981,2019,38,31-40
4071,"Laflamme, Ovide",M,31,1925,1979,54,51-60
4072,"Benjamin, Leslie Gordon",M,31,1925,1979,54,51-60
4073,"Howard, Frank",M,31,1925,1979,54,51-60
4074,"Laprise, Gérard",M,31,1925,1979,54,51-60
4075,"Lawrence, Allan Frederick",M,31,1925,1979,54,51-60
4076,"Stackhouse, Reginald Francis",M,31,1925,1979,54,51-60
4077,"Corriveau, Léopold",M,31,1926,1979,53,51-60
4078,"Dubé, Jean-Eudes",M,31,1926,1979,53,51-60
4079,"Éthier, Denis",M,31,1926,1979,53,51-60
4080,"Godin, Roland",M,31,1926,1979,53,51-60
4081,"Lachance, Georges-C.",M,31,1926,1979,53,51-60
4082,"Langlois, Paul",M,31,1926,1979,53,51-60
4083,"Lessard, Marcel",M,31,1926,1979,53,51-60
4084,"Cossitt, Thomas Charles",M,31,1927,1979,52,51-60
4085,"Cullen, Jack Sydney George (Bud)",M,31,1927,1979,52,51-60
4086,"Hollands, Daniel Fulton",M,31,1927,1979,52,51-60
4087,"Holmes, John Robert",M,31,1927,1979,52,51-60
4088,"Horner, John (Jack) Henry",M,31,1927,1979,52,51-60
4089,"Stevens, Sinclair McKnight",M,31,1927,1979,52,51-60
4090,"Rondeau, Gilbert F.",M,31,1928,1979,51,51-60
4091,"Campbell, W. Bennett",M,32,1943,1980,37,31-40
4092,"Keeper, Cyril",M,32,1943,1980,37,31-40
4093,"Landers, Mike",M,32,1943,1980,37,31-40
4094,"Murta, Jack Burnett",M,32,1943,1980,37,31-40
4095,"Tessier, Claude",M,32,1943,1980,37,31-40
4096,"Vankoughnet, William John",M,32,1943,1980,37,31-40
4097,"Angus, Iain Francis",M,33,1947,1984,37,31-40
4098,"Bosley, John William",M,33,1947,1984,37,31-40
4099,"Clinch, J. Roger",M,33,1947,1984,37,31-40
4100,"Daubney, David Bruce",M,33,1947,1984,37,31-40
4101,"Hamelin, Charles-André",M,33,1947,1984,37,31-40
4102,"MacDougall, John Alexander Frances",M,33,1947,1984,37,31-40
4103,"Blaikie, William Alexander (Bill)",M,34,1951,1988,37,31-40
4104,"Blondin-Andrew, Ethel Dorothy",F,34,1951,1988,37,31-40
4105,"Sobeski, Patrick (Pat) Anthony",M,34,1951,1988,37,31-40
4106,"White, Brian",M,34,1951,1988,37,31-40
4107,"Iftody, David",M,35,1956,1993,37,31-40
4108,"Knutson, Gar",M,35,1956,1993,37,31-40
4109,"Marchi, Sergio",M,35,1956,1993,37,31-40
4110,"Mitchell, Andrew (Andy)",M,35,1956,1993,37,31-40
4111,"Speller, Robert (Bob)",M,35,1956,1993,37,31-40
4112,"Bernier, Yvan",M,36,1960,1997,37,31-40
4113,"Bevilacqua, Maurizio",M,36,1960,1997,37,31-40
4114,"Martin, Keith P.",M,36,1960,1997,37,31-40
4115,"Vautour, Angela",F,36,1960,1997,37,31-40
4116,"Bellehumeur, Michel",M,37,1963,2000,37,31-40
4117,"Coderre, Denis",M,37,1963,2000,37,31-40
4118,"Lanctôt, Robert",M,37,1963,2000,37,31-40
4119,"Peschisolido, Joe",M,37,1963,2000,37,31-40
4120,"Sauvageau, Benoît",M,37,1963,2000,37,31-40
4121,"Savoy, Andy",M,37,1963,2000,37,31-40
4122,"Whelan, Susan",F,36,1963,1997,34,31-40
4123,"Brison, Scott",M,38,1967,2004,37,31-40
4124,"LeBlanc, Dominic",M,38,1967,2004,37,31-40
4125,"Rodriguez, Pablo",M,38,1967,2004,37,31-40
4126,"Alghabra, Omar",M,39,1969,2006,37,31-40
4127,"Ambrose, Rona",F,39,1969,2006,37,31-40
4128,"Baird, John",M,39,1969,2006,37,31-40
4129,"Batters, Dave",M,39,1969,2006,37,31-40
4130,"Bigras, Bernard",M,39,1969,2006,37,31-40
4131,"Guergis, Helena",F,39,1969,2006,37,31-40
4132,"Hiebert, Russ",M,39,1969,2006,37,31-40
4133,"Lake, Mike",M,39,1969,2006,37,31-40
4134,"Mourani, Maria",F,39,1969,2006,37,31-40
4135,"Simms, Scott",M,39,1969,2006,37,31-40
4136,"St-Hilaire, Caroline",F,39,1969,2006,37,31-40
4137,"Chong, Michael D.",M,40,1971,2008,37,31-40
4138,"Trudeau, Justin",M,40,1971,2008,37,31-40
4139,"Watson, Jeff",M,39,1971,2006,35,31-40
4140,"Adams, Eve",F,41,1974,2011,37,31-40
4141,"Andrews, Scott",M,41,1974,2011,37,31-40
4142,"Choquette, François",M,41,1974,2011,37,31-40
4143,"Gill, Parm",M,41,1974,2011,37,31-40
4144,"Hassainia, Sana",F,41,1974,2011,37,31-40
4145,"Hillyer, Jim",M,41,1974,2011,37,31-40
4146,"Moore, Rob",M,41,1974,2011,37,31-40
4147,"Paradis, Christian",M,41,1974,2011,37,31-40
4148,"Richards, Blake",M,41,1974,2011,37,31-40
4149,"Trost, Brad",M,41,1974,2011,37,31-40
4150,"Uppal, Tim",M,41,1974,2011,37,31-40
4151,"Blaikie, Daniel",M,42,1978,2015,37,31-40
4152,"Fraser, Colin",M,42,1978,2015,37,31-40
4153,"Strahl, Mark",M,42,1978,2015,37,31-40
4154,"Warkentin, Chris",M,41,1978,2011,33,31-40
4155,"Ashton, Niki",F,43,1982,2019,37,31-40
4156,"Larouche, Andréanne",F,43,1982,2019,37,31-40
4157,"Ste-Marie, Gabriel",M,43,1982,2019,37,31-40
4158,"van Koeverden, Adam",M,43,1982,2019,37,31-40
4159,"Vis, Brad",M,43,1982,2019,37,31-40
4160,"Cafik, Norman Augustine",M,31,1928,1979,51,51-60
4161,"Coates, Robert Carman",M,31,1928,1979,51,51-60
4162,"Grafftey, William Heward",M,31,1928,1979,51,51-60
4163,"Hurlburt, Kenneth Earl",M,31,1928,1979,51,51-60
4164,"La Salle, Roch",M,31,1928,1979,51,51-60
4165,"Lajoie, Claude G.",M,31,1928,1979,51,51-60
4166,"Marceau, Gilles",M,31,1928,1979,51,51-60
4167,"McKinley, Robert Elgin",M,31,1928,1979,51,51-60
4168,"Paproski, Steve Eugene",M,31,1928,1979,51,51-60
4169,"Portelance, Arthur",M,31,1928,1979,51,51-60
4170,"Stewart, Donald Craig",M,31,1928,1979,51,51-60
4171,"Côté, Florian",M,31,1929,1979,50,41-50
4172,"Kuntz, Harry",M,31,1929,1979,50,41-50
4173,"Bawden, Peter Colwell",M,31,1929,1979,50,41-50
4174,"Beattie, Duncan M.",M,31,1929,1979,50,41-50
4175,"Breau, Herb",M,32,1944,1980,36,31-40
4176,"Bujold, Joseph Roger Rémi",M,32,1944,1980,36,31-40
4177,"Elzinga, Peter",M,32,1944,1980,36,31-40
4178,"Lapointe, Charles",M,32,1944,1980,36,31-40
4179,"Nickerson, Dave",M,32,1944,1980,36,31-40
4180,"Olivier, Joseph Mario Jacques",M,32,1944,1980,36,31-40
4181,"Binns, Patrick George",M,33,1948,1984,36,31-40
4182,"Blackburn, Jean-Pierre",M,33,1948,1984,36,31-40
4183,"Blais, Pierre",M,33,1948,1984,36,31-40
4184,"Cadieux, Pierre H.",M,33,1948,1984,36,31-40
4185,"Cossitt, Jennifer",F,33,1948,1984,36,31-40
4186,"Harris, Jack",M,33,1948,1984,36,31-40
4187,"Schellenberger, Stanley Kenneth",M,33,1948,1984,36,31-40
4188,"Arseneault, Guy H.",M,34,1952,1988,36,31-40
4189,"Cooper, Albert Glen",M,34,1952,1988,36,31-40
4190,"Copps, Sheila Maureen",F,34,1952,1988,36,31-40
4191,"Dingwall, David Charles",M,34,1952,1988,36,31-40
4192,"Grey, Deborah C.",F,34,1952,1988,36,31-40
4193,"Harvey, Ross",M,34,1952,1988,36,31-40
4194,"Nicholson, Rob",M,34,1952,1988,36,31-40
4195,"Reid, Ian Angus Ross",M,34,1952,1988,36,31-40
4196,"Robinson, Svend Johannes",M,34,1952,1988,36,31-40
4197,"Taylor, Leonard William (Len)",M,34,1952,1988,36,31-40
4198,"Valcourt, Bernard",M,34,1952,1988,36,31-40
4199,"Anderson, David",M,35,1957,1993,36,31-40
4200,"Anderson, David",M,35,1957,1993,36,31-40
4201,"Ianno, Tony",M,35,1957,1993,36,31-40
4202,"Strahl, Charles (Chuck)",M,35,1957,1993,36,31-40
4203,"Valeri, Tony",M,35,1957,1993,36,31-40
4204,"Bonwick, Paul",M,37,1964,2000,36,31-40
4205,"Herron, John",M,37,1964,2000,36,31-40
4206,"Reid, Scott",M,37,1964,2000,36,31-40
4207,"Kenney, Jason",M,38,1968,2004,36,31-40
4208,"Masse, Brian",M,38,1968,2004,36,31-40
4209,"Del Mastro, Dean",M,39,1970,2006,36,31-40
4210,"Rajotte, James",M,39,1970,2006,36,31-40
4211,"Anders, Rob",M,40,1972,2008,36,31-40
4212,"Cullen, Nathan",M,40,1972,2008,36,31-40
4213,"D'Amours, Jean-Claude",M,40,1972,2008,36,31-40
4214,"Faille, Meili",F,40,1972,2008,36,31-40
4215,"Fletcher, Steven John",M,40,1972,2008,36,31-40
4216,"Thi Lac, Ève-Mary Thaï",F,40,1972,2008,36,31-40
4217,"Bittle, Chris",M,42,1979,2015,36,31-40
4218,"Dhillon, Anju",F,42,1979,2015,36,31-40
4219,"Dzerowicz, Julie",F,42,1979,2015,36,31-40
4220,"Joly, Mélanie",F,42,1979,2015,36,31-40
4221,"Ouellette, Robert-Falcon",M,42,1979,2015,36,31-40
4222,"Poilievre, Pierre",M,42,1979,2015,36,31-40
4223,"Scheer, Andrew",M,42,1979,2015,36,31-40
4224,"Schiefke, Peter",M,42,1979,2015,36,31-40
4225,"Singh, Jagmeet",M,42,1979,2015,36,31-40
4226,"Stubbs, Shannon",F,42,1979,2015,36,31-40
4227,"Drouin, Francis",M,43,1983,2019,36,31-40
4228,"O'Connell, Jennifer",F,43,1983,2019,36,31-40
4229,"Buchanan, J. Judd",M,31,1929,1979,50,41-50
4230,"Carter, Walter C.",M,31,1929,1979,50,41-50
4231,"Comtois, Joseph-Roland",M,31,1929,1979,50,41-50
4232,"Ellis, John Raymond",M,31,1929,1979,50,41-50
4233,"Howie, J. Robert",M,31,1929,1979,50,41-50
4234,"Korchinski, Stanley James",M,31,1929,1979,50,41-50
4235,"Lalonde, Marc",M,31,1929,1979,50,41-50
4236,"Olaussen, Harry Magnus",M,31,1929,1979,50,41-50
4237,"Stanbury, Robert Douglas George",M,31,1929,1979,50,41-50
4238,"Stewart, Ralph Wesley",M,31,1929,1979,50,41-50
4239,"Turner, John Napier",M,31,1929,1979,50,41-50
4240,"Baker, Walter David",M,31,1930,1979,49,41-50
4241,"Blenkarn, Donald Alex",M,31,1930,1979,49,41-50
4242,"Caccia, Charles L.",M,31,1930,1979,49,41-50
4243,"Hopkins, Leonard Donald",M,31,1930,1979,49,41-50
4244,"Horner, Norval Alic",M,31,1930,1979,49,41-50
4245,"Jarvis, William Herbert",M,31,1930,1979,49,41-50
4246,"Fraser, John Allen",M,31,1931,1979,48,41-50
4247,"Gray, Herbert Eser (Herb)",M,31,1931,1979,48,41-50
4248,"Harney, John Paul",M,31,1931,1979,48,41-50
4249,"Leggatt, Stuart Malcolm",M,31,1931,1979,48,41-50
4250,"MacGuigan, Mark R.",M,31,1931,1979,48,41-50
4251,"Munro, John Carr",M,31,1931,1979,48,41-50
4252,"Nesdoly, Elias (Eli)",M,31,1931,1979,48,41-50
4253,"Nowlan, John Patrick (Pat)",M,31,1931,1979,48,41-50
4254,"Poulin, Fabian Hugh",M,31,1931,1979,48,41-50
4255,"Frith, Douglas Cockburn",M,32,1945,1980,35,31-40
4256,"McMillan, Thomas Michael",M,32,1945,1980,35,31-40
4257,"Boudria, Don",M,33,1949,1984,35,31-40
4258,"Desjardins, Gabriel",M,33,1949,1984,35,31-40
4259,"Girard, Albert",M,33,1949,1984,35,31-40
4260,"Toupin, Robert",M,33,1949,1984,35,31-40
4261,"Guarnieri, Albina",F,34,1953,1988,35,31-40
4262,"Keyes, Stan Kazmierczak",M,34,1953,1988,35,31-40
4263,"Laporte, Rodney Edward",M,34,1953,1988,35,31-40
4264,"LeBlanc, Francis G.",M,34,1953,1988,35,31-40
4265,"O'Kurley, Brian Alexander",M,34,1953,1988,35,31-40
4266,"Pronovost, Denis",M,34,1953,1988,35,31-40
4267,"Charest, Jean J.",M,35,1958,1993,35,31-40
4268,"Kirkby, Gordon",M,35,1958,1993,35,31-40
4269,"Solberg, Monte",M,35,1958,1993,35,31-40
4270,"Cauchon, Martin",M,36,1962,1997,35,31-40
4271,"Dubé, Jean F.",M,36,1962,1997,35,31-40
4272,"McNally, Grant",M,36,1962,1997,35,31-40
4273,"McTeague, Dan",M,36,1962,1997,35,31-40
4274,"Ménard, Réal",M,36,1962,1997,35,31-40
4275,"Torsney, Paddy",F,36,1962,1997,35,31-40
4276,"Bergeron, Stéphane",M,37,1965,2000,35,31-40
4277,"MacKay, Peter Gordon",M,37,1965,2000,35,31-40
4278,"Ambrose, Rona",F,38,1969,2004,35,31-40
4279,"Batters, Dave",M,38,1969,2004,35,31-40
4280,"Bigras, Bernard",M,38,1969,2004,35,31-40
4281,"Guergis, Helena",F,38,1969,2004,35,31-40
4282,"Hiebert, Russ",M,38,1969,2004,35,31-40
4283,"Simms, Scott",M,38,1969,2004,35,31-40
4284,"St-Hilaire, Caroline",F,38,1969,2004,35,31-40
4285,"Chong, Michael D.",M,39,1971,2006,35,31-40
4286,"Jaffer, Rahim",M,39,1971,2006,35,31-40
4287,"Watson, Jeff",M,38,1971,2004,33,31-40
4288,"Bruinooge, Rod",M,40,1973,2008,35,31-40
4289,"Leslie, Megan",F,40,1973,2008,35,31-40
4290,"Malo, Luc",M,40,1973,2008,35,31-40
4291,"Albas, Dan",M,41,1976,2011,35,31-40
4292,"Lobb, Ben",M,41,1976,2011,35,31-40
4293,"Moore, James",M,41,1976,2011,35,31-40
4294,"Bendayan, Rachel",F,42,1980,2015,35,31-40
4295,"Chagger, Bardish",F,42,1980,2015,35,31-40
4296,"Chen, Shaun",M,42,1980,2015,35,31-40
4297,"Harder, Rachael",F,42,1980,2015,35,31-40
4298,"Rempel Garner, Michelle",F,42,1980,2015,35,31-40
4299,"Sahota, Ruby",F,42,1980,2015,35,31-40
4300,"Barrett, Michael",M,43,1984,2019,35,31-40
4301,"Collins, Laurel",F,43,1984,2019,35,31-40
4302,"Erskine-Smith, Nathaniel",M,43,1984,2019,35,31-40
4303,"Falk, Rosemarie",F,43,1984,2019,35,31-40
4304,"Monsef, Maryam",F,43,1984,2019,35,31-40
4305,"Nater, John",M,43,1984,2019,35,31-40
4306,"Sidhu, Maninder",M,43,1984,2019,35,31-40
4307,"Sikand, Gagan",M,43,1984,2019,35,31-40
4308,"Sloan, Derek",M,43,1984,2019,35,31-40
4309,"Tabbara, Marwan",M,43,1984,2019,35,31-40
4310,"Lewycky, Laverne",M,32,1946,1980,34,31-40
4311,"Taylor, Charles Keith",M,31,1931,1979,48,41-50
4312,"Allmand, William Warren",M,31,1932,1979,47,41-50
4313,"Basford, Stanley Ronald",M,31,1932,1979,47,41-50
4314,"Goyer, Jean-Pierre",M,31,1932,1979,47,41-50
4315,"Lang, Otto Emil",M,31,1932,1979,47,41-50
4316,"Macdonald, Donald Stovel",M,31,1932,1979,47,41-50
4317,"McGrath, James Aloysius",M,31,1932,1979,47,41-50
4318,"Oberle, Frank",M,31,1932,1979,47,41-50
4319,"Clarke, William Hillary (Bill)",M,31,1933,1979,46,41-50
4320,"Faulkner, James Hugh",M,31,1933,1979,46,41-50
4321,"Foster, Maurice Brydon",M,31,1933,1979,46,41-50
4322,"Guay, Raynald Joseph Albert",M,31,1933,1979,46,41-50
4323,"Jerome, James Alexander",M,31,1933,1979,46,41-50
4324,"Penner, B. Keith",M,31,1933,1979,46,41-50
4325,"Reilly, Peter",M,31,1933,1979,46,41-50
4326,"Schumacher, Stanley Stanford",M,31,1933,1979,46,41-50
4327,"Higson, Kenneth James",M,31,1934,1979,45,41-50
4328,"Collenette, David Michael",M,32,1946,1980,34,31-40
4329,"Murphy, Rodney Edward",M,32,1946,1980,34,31-40
4330,"Nystrom, Lorne Edmund",M,32,1946,1980,34,31-40
4331,"Sargeant, Terence James (Terry)",M,32,1946,1980,34,31-40
4332,"Tardif, Alain",M,32,1946,1980,34,31-40
4333,"Berger, David",M,33,1950,1984,34,31-40
4334,"Bourgault, Lise",F,33,1950,1984,34,31-40
4335,"Cochrane, Dennis H.",M,33,1950,1984,34,31-40
4336,"Fulton, James Ross",M,33,1950,1984,34,31-40
4337,"Suluk, Thomas",M,33,1950,1984,34,31-40
4338,"Chartrand, Gilbert",M,34,1954,1988,34,31-40
4339,"Dorin, Murray",M,34,1954,1988,34,31-40
4340,"Hughes, Kenneth Gardner",M,34,1954,1988,34,31-40
4341,"Tobin, Brian Vincent",M,34,1954,1988,34,31-40
4342,"Guay, Monique",F,35,1959,1993,34,31-40
4343,"Harper, Stephen",M,35,1959,1993,34,31-40
4344,"Loubier, Yvan",M,35,1959,1993,34,31-40
4345,"Regan, Geoff",M,35,1959,1993,34,31-40
4346,"Bellehumeur, Michel",M,36,1963,1997,34,31-40
4347,"Coderre, Denis",M,36,1963,1997,34,31-40
4348,"Sauvageau, Benoît",M,36,1963,1997,34,31-40
4349,"Byrne, Gerry",M,37,1966,2000,34,31-40
4350,"Pankiw, Jim",M,37,1966,2000,34,31-40
4351,"Marceau, Richard",M,38,1970,2004,34,31-40
4352,"Rajotte, James",M,38,1970,2004,34,31-40
4353,"Anders, Rob",M,39,1972,2006,34,31-40
4354,"Cullen, Nathan",M,39,1972,2006,34,31-40
4355,"D'Amours, Jean-Claude",M,39,1972,2006,34,31-40
4356,"Faille, Meili",F,39,1972,2006,34,31-40
4357,"Fletcher, Steven John",M,39,1972,2006,34,31-40
4358,"Thi Lac, Ève-Mary Thaï",F,39,1972,2006,34,31-40
4359,"Andrews, Scott",M,40,1974,2008,34,31-40
4360,"Dhalla, Ruby",F,40,1974,2008,34,31-40
4361,"Holland, Mark",M,40,1974,2008,34,31-40
4362,"Moore, Rob",M,40,1974,2008,34,31-40
4363,"Paradis, Christian",M,40,1974,2008,34,31-40
4364,"Richards, Blake",M,40,1974,2008,34,31-40
4365,"Trost, Brad",M,40,1974,2008,34,31-40
4366,"Uppal, Tim",M,40,1974,2008,34,31-40
4367,"Beech, Terry",M,42,1981,2015,34,31-40
4368,"Fragiskatos, Peter",M,42,1981,2015,34,31-40
4369,"Graham, David",M,42,1981,2015,34,31-40
4370,"Kmiec, Tom",M,42,1981,2015,34,31-40
4371,"Khalid, Iqra",F,43,1985,2019,34,31-40
4372,"Blackburn, Derek Nigel Ernest",M,31,1934,1979,45,41-50
4373,"Chrétien, Joseph Jacques Jean",M,31,1934,1979,45,41-50
4374,"Watson, Ian",M,31,1934,1979,45,41-50
4375,"Firth, Walter (Wally)",M,31,1935,1979,44,41-50
4376,"Matte, René",M,31,1935,1979,44,41-50
4377,"Bosley, John William",M,32,1947,1980,33,31-40
4378,"Deniger, Pierre",M,32,1947,1980,33,31-40
4379,"MacDougall, John Alexander Frances",M,32,1947,1980,33,31-40
4380,"Massé, Paul-André",M,32,1947,1980,33,31-40
4381,"Blaikie, William Alexander (Bill)",M,33,1951,1984,33,31-40
4382,"White, Brian",M,33,1951,1984,33,31-40
4383,"Gardiner, Brian L.",M,34,1955,1988,33,31-40
4384,"Karygiannis, Jim",M,34,1955,1988,33,31-40
4385,"MacDonald, Ronald",M,34,1955,1988,33,31-40
4386,"Nault, Robert Daniel",M,34,1955,1988,33,31-40
4387,"Nunziata, John V.",M,34,1955,1988,33,31-40
4388,"Robitaille, Jean-Marc",M,34,1955,1988,33,31-40
4389,"Vincent, Pierre H.",M,34,1955,1988,33,31-40
4390,"Bernier, Yvan",M,35,1960,1993,33,31-40
4391,"Bevilacqua, Maurizio",M,35,1960,1993,33,31-40
4392,"Martin, Keith P.",M,35,1960,1993,33,31-40
4393,"Bonwick, Paul",M,36,1964,1997,33,31-40
4394,"Herron, John",M,36,1964,1997,33,31-40
4395,"Brison, Scott",M,37,1967,2000,33,31-40
4396,"LeBlanc, Dominic",M,37,1967,2000,33,31-40
4397,"Boire, Alain",M,38,1971,2004,33,31-40
4398,"Chong, Michael D.",M,38,1971,2004,33,31-40
4399,"Jaffer, Rahim",M,38,1971,2004,33,31-40
4400,"Bruinooge, Rod",M,39,1973,2006,33,31-40
4401,"Malo, Luc",M,39,1973,2006,33,31-40
4402,"Brown, Patrick W.",M,41,1978,2011,33,31-40
4403,"Storseth, Brian",M,41,1978,2011,33,31-40
4404,"Strahl, Mark",M,41,1978,2011,33,31-40
4405,"Warkentin, Chris",M,40,1978,2008,30,18-30
4406,"Ashton, Niki",F,42,1982,2015,33,31-40
4407,"Harvey, Thomas J.",M,42,1982,2015,33,31-40
4408,"Quach, Anne Minh-Thu",F,42,1982,2015,33,31-40
4409,"Ste-Marie, Gabriel",M,42,1982,2015,33,31-40
4410,"Viersen, Arnold",M,42,1986,2015,29,18-30
4411,"Viersen, Arnold",M,43,1986,2019,33,31-40
4412,"Weiler, Patrick",M,43,1986,2019,33,31-40
4413,"Mazankowski, Donald Frank",M,31,1935,1979,44,41-50
4414,"Wise, John",M,31,1935,1979,44,41-50
4415,"Bégin, Monique",F,31,1936,1979,43,41-50
4416,"Blaker, Roderick",M,31,1936,1979,43,41-50
4417,"Broadbent, John Edward",M,31,1936,1979,43,41-50
4418,"Campbell, John",M,31,1936,1979,43,41-50
4419,"Grier, Terrence Wyly",M,31,1936,1979,43,41-50
4420,"Guilbault, Jacques",M,31,1936,1979,43,41-50
4421,"MacDonald, David Samuel Horne",M,31,1936,1979,43,41-50
4422,"MacKay, Elmer MacIntosh",M,31,1936,1979,43,41-50
4423,"Roy, Marcel-Claude",M,31,1936,1979,43,41-50
4424,"Yewchuk, Paul",M,31,1937,1979,42,41-50
4425,"Caron, Yves",M,31,1937,1979,42,41-50
4426,"Cossitt, Jennifer",F,32,1948,1980,32,31-40
4427,"Dubois, Jean-Guy",M,32,1948,1980,32,31-40
4428,"Loiselle, Bernard Pierre",M,32,1948,1980,32,31-40
4429,"Maltais, André",M,32,1948,1980,32,31-40
4430,"Rae, Bob",M,32,1948,1980,32,31-40
4431,"Schellenberger, Stanley Kenneth",M,32,1948,1980,32,31-40
4432,"Cooper, Albert Glen",M,33,1952,1984,32,31-40
4433,"Copps, Sheila Maureen",F,33,1952,1984,32,31-40
4434,"Dingwall, David Charles",M,33,1952,1984,32,31-40
4435,"Nicholson, Rob",M,33,1952,1984,32,31-40
4436,"Robinson, Svend Johannes",M,33,1952,1984,32,31-40
4437,"Schellenberg, Ted William",M,33,1952,1984,32,31-40
4438,"Valcourt, Bernard",M,33,1952,1984,32,31-40
4439,"Champagne, Michel",M,34,1956,1988,32,31-40
4440,"Lapierre, Jean-C.",M,34,1956,1988,32,31-40
4441,"Marchi, Sergio",M,34,1956,1988,32,31-40
4442,"Speller, Robert (Bob)",M,34,1956,1988,32,31-40
4443,"Bergeron, Stéphane",M,36,1965,1997,32,31-40
4444,"MacKay, Peter Gordon",M,36,1965,1997,32,31-40
4445,"Kenney, Jason",M,37,1968,2000,32,31-40
4446,"Masse, Brian",M,37,1968,2000,32,31-40
4447,"Anders, Rob",M,38,1972,2004,32,31-40
4448,"Cullen, Nathan",M,38,1972,2004,32,31-40
4449,"D'Amours, Jean-Claude",M,38,1972,2004,32,31-40
4450,"Faille, Meili",F,38,1972,2004,32,31-40
4451,"Fletcher, Steven John",M,38,1972,2004,32,31-40
4452,"Dhalla, Ruby",F,39,1974,2006,32,31-40
4453,"Holland, Mark",M,39,1974,2006,32,31-40
4454,"Moore, Rob",M,39,1974,2006,32,31-40
4455,"Paradis, Christian",M,39,1974,2006,32,31-40
4456,"Trost, Brad",M,39,1974,2006,32,31-40
4457,"Lobb, Ben",M,40,1976,2008,32,31-40
4458,"Moore, James",M,40,1976,2008,32,31-40
4459,"Genest-Jourdain, Jonathan",M,41,1979,2011,32,31-40
4460,"Harris, Dan",M,41,1979,2011,32,31-40
4461,"Poilievre, Pierre",M,41,1979,2011,32,31-40
4462,"Scheer, Andrew",M,41,1979,2011,32,31-40
4463,"DeCourcey, Matt",M,42,1983,2015,32,31-40
4464,"Drouin, Francis",M,42,1983,2015,32,31-40
4465,"Moore, Christine",F,42,1983,2015,32,31-40
4466,"O'Connell, Jennifer",F,42,1983,2015,32,31-40
4467,"Duncan, Eric",M,43,1987,2019,32,31-40
4468,"Genuis, Garnett",M,43,1987,2019,32,31-40
4469,"Gould, Karina",F,43,1987,2019,32,31-40
4470,"Patzer, Jeremy",M,43,1987,2019,32,31-40
4471,"Beatty, Henry Perrin",M,31,1937,1979,42,41-50
4472,"Hueglin, Joseph Fred",M,31,1937,1979,42,41-50
4473,"Reid, John Mercer",M,31,1937,1979,42,41-50
4474,"Rodriguez, John R.",M,31,1937,1979,42,41-50
4475,"Rooney, Richard David (Dave)",M,31,1937,1979,42,41-50
4476,"Demers, Yves",M,31,1938,1979,41,41-50
4477,"Haliburton, Charles E.",M,31,1938,1979,41,41-50
4478,"Stewart, William Douglas",M,31,1938,1979,41,41-50
4479,"Boisvert, Jean-Marie",M,31,1939,1979,40,31-40
4480,"Gimaïel, Pierre J.J. Georges Adelard",M,32,1949,1980,31,31-40
4481,"Lonsdale, Bruce",M,32,1949,1980,31,31-40
4482,"Peterson, Peter James",M,33,1953,1984,31,31-40
4483,"Cauchon, Martin",M,35,1962,1993,31,31-40
4484,"Gagnon, Patrick",M,35,1962,1993,31,31-40
4485,"McTeague, Dan",M,35,1962,1993,31,31-40
4486,"Ménard, Réal",M,35,1962,1993,31,31-40
4487,"Torsney, Paddy",F,35,1962,1993,31,31-40
4488,"Byrne, Gerry",M,36,1966,1997,31,31-40
4489,"Pankiw, Jim",M,36,1966,1997,31,31-40
4490,"Bigras, Bernard",M,37,1969,2000,31,31-40
4491,"St-Hilaire, Caroline",F,37,1969,2000,31,31-40
4492,"Gagnon, Sébastien",M,38,1973,2004,31,31-40
4493,"Bains, Navdeep Singh",M,40,1977,2008,31,31-40
4494,"St-Cyr, Thierry",M,40,1977,2008,31,31-40
4495,"Papillon, Annick",F,41,1980,2011,31,31-40
4496,"Rempel Garner, Michelle",F,41,1980,2011,31,31-40
4497,"Barrett, Michael",M,42,1984,2015,31,31-40
4498,"Brosseau, Ruth Ellen",F,42,1984,2015,31,31-40
4499,"Erskine-Smith, Nathaniel",M,42,1984,2015,31,31-40
4500,"Falk, Rosemarie",F,42,1984,2015,31,31-40
4501,"Fraser, Sean",M,42,1984,2015,31,31-40
4502,"Monsef, Maryam",F,42,1984,2015,31,31-40
4503,"Nater, John",M,42,1984,2015,31,31-40
4504,"Sikand, Gagan",M,42,1984,2015,31,31-40
4505,"Tabbara, Marwan",M,42,1984,2015,31,31-40
4506,"Barsalou-Duval, Xavier",M,43,1988,2019,31,31-40
4507,"Lightbound, Joël",M,43,1988,2019,31,31-40
4508,"Savard-Tremblay, Simon-Pierre",M,43,1988,2019,31,31-40
4509,"Clark, Charles Joseph",M,31,1939,1979,40,31-40
4510,"Epp, Arthur Jacob (Jake)",M,31,1939,1979,40,31-40
4511,"Fleming, James Sydney Clark",M,31,1939,1979,40,31-40
4512,"Lundrigan, John Howard",M,31,1939,1979,40,31-40
4513,"Ouellet, André",M,31,1939,1979,40,31-40
4514,"Pelletier, Irénée",M,31,1939,1979,40,31-40
4515,"Andre, Harvie",M,31,1940,1979,39,31-40
4516,"Anguish, Douglas Keith",M,32,1950,1980,30,18-30
4517,"Berger, David",M,32,1950,1980,30,18-30
4518,"Fulton, James Ross",M,32,1950,1980,30,18-30
4519,"Gourde, Gaston",M,32,1950,1980,30,18-30
4520,"Ittinuar, Peter",M,32,1950,1980,30,18-30
4521,"Lang, Peter Joseph",M,32,1950,1980,30,18-30
4522,"Chartrand, Gilbert",M,33,1954,1984,30,18-30
4523,"Dorin, Murray",M,33,1954,1984,30,18-30
4524,"O'Neil, Lawrence I.",M,33,1954,1984,30,18-30
4525,"Tobin, Brian Vincent",M,33,1954,1984,30,18-30
4526,"Charest, Jean J.",M,34,1958,1988,30,18-30
4527,"Thorkelson, Scott Jon",M,34,1958,1988,30,18-30
4528,"Bellehumeur, Michel",M,35,1963,1993,30,18-30
4529,"Sauvageau, Benoît",M,35,1963,1993,30,18-30
4530,"Whelan, Susan",F,35,1963,1993,30,18-30
4531,"Brison, Scott",M,36,1967,1997,30,18-30
4532,"Brien, Pierre",M,37,1970,2000,30,18-30
4533,"Marceau, Richard",M,37,1970,2000,30,18-30
4534,"Rajotte, James",M,37,1970,2000,30,18-30
4535,"Dhalla, Ruby",F,38,1974,2004,30,18-30
4536,"Holland, Mark",M,38,1974,2004,30,18-30
4537,"Moore, Rob",M,38,1974,2004,30,18-30
4538,"Trost, Brad",M,38,1974,2004,30,18-30
4539,"Moore, James",M,39,1976,2006,30,18-30
4540,"Brown, Patrick W.",M,40,1978,2008,30,18-30
4541,"Paillé, Pascal-Pierre",M,40,1978,2008,30,18-30
4542,"Storseth, Brian",M,40,1978,2008,30,18-30
4543,"Warkentin, Chris",M,39,1978,2006,28,18-30
4544,"Sitsabaiesan, Rathika",F,41,1981,2011,30,18-30
4545,"Grewal, Raj",M,42,1985,2015,30,18-30
4546,"Khalid, Iqra",F,42,1985,2015,30,18-30
4547,"Nuttall, Alex",M,42,1985,2015,30,18-30
4548,"Blanchette-Joncas, Maxime",M,43,1989,2019,30,18-30
4549,"Khera, Kamal",F,43,1989,2019,30,18-30
4550,"Blais, Jean-Jacques",M,31,1940,1979,39,31-40
4551,"Caouette, Gilles",M,31,1940,1979,39,31-40
4552,"Blaikie, William Alexander (Bill)",M,32,1951,1980,29,18-30
4553,"Nunziata, John V.",M,33,1955,1984,29,18-30
4554,"Vincent, Pierre H.",M,33,1955,1984,29,18-30
4555,"Kenney, Jason",M,36,1968,1997,29,18-30
4556,"Jaffer, Rahim",M,37,1971,2000,29,18-30
4557,"Bains, Navdeep Singh",M,39,1977,2006,29,18-30
4558,"St-Cyr, Thierry",M,39,1977,2006,29,18-30
4559,"Poilievre, Pierre",M,40,1979,2008,29,18-30
4560,"Scheer, Andrew",M,40,1979,2008,29,18-30
4561,"Ashton, Niki",F,41,1982,2011,29,18-30
4562,"Quach, Anne Minh-Thu",F,41,1982,2011,29,18-30
4563,"Clarke, Alupa",M,42,1986,2015,29,18-30
4564,"Dancho, Raquel",F,43,1990,2019,29,18-30
4565,"Kurek, Damien C.",M,43,1990,2019,29,18-30
4566,"Lambropoulos, Emmanuella",F,43,1990,2019,29,18-30
4567,"Dick, Paul Wyatt",M,31,1940,1979,39,31-40
4568,"Jelinek, Otto John",M,31,1940,1979,39,31-40
4569,"O'Connor, Terrance Patrick (Terry)",M,31,1940,1979,39,31-40
4570,"Cooper, Albert Glen",M,32,1952,1980,28,18-30
4571,"Dingwall, David Charles",M,32,1952,1980,28,18-30
4572,"Garant, Alain",M,32,1952,1980,28,18-30
4573,"Robinson, Svend Johannes",M,32,1952,1980,28,18-30
4574,"Champagne, Michel",M,33,1956,1984,28,18-30
4575,"Lapierre, Jean-C.",M,33,1956,1984,28,18-30
4576,"Marchi, Sergio",M,33,1956,1984,28,18-30
4577,"Bevilacqua, Maurizio",M,34,1960,1988,28,18-30
4578,"Jacques, Carole",F,34,1960,1988,28,18-30
4579,"Bergeron, Stéphane",M,35,1965,1993,28,18-30
4580,"Bigras, Bernard",M,36,1969,1997,28,18-30
4581,"St-Hilaire, Caroline",F,36,1969,1997,28,18-30
4582,"Anders, Rob",M,37,1972,2000,28,18-30
4583,"Hill, Grant",M,37,1972,2000,28,18-30
4584,"Moore, James",M,38,1976,2004,28,18-30
4585,"Brown, Patrick W.",M,39,1978,2006,28,18-30
4586,"Storseth, Brian",M,39,1978,2006,28,18-30
4587,"Moore, Christine",F,41,1983,2011,28,18-30
4588,"Genuis, Garnett",M,42,1987,2015,28,18-30
4589,"Gould, Karina",F,42,1987,2015,28,18-30
4590,"Blois, Kody",M,43,1991,2019,28,18-30
4591,"Lloyd, Dane",M,43,1991,2019,28,18-30
4592,"Rowland, Douglas Charles",M,31,1940,1979,39,31-40
4593,"Atkey, Ronald George",M,31,1942,1979,37,31-40
4594,"Dupont, Raymond",M,31,1942,1979,37,31-40
4595,"Reynolds, John Douglas",M,31,1942,1979,37,31-40
4596,"Byrne, Gerry",M,35,1966,1993,27,18-30
4597,"Brien, Pierre",M,36,1970,1997,27,18-30
4598,"Marceau, Richard",M,36,1970,1997,27,18-30
4599,"Gagnon, Sébastien",M,37,1973,2000,27,18-30
4600,"Tremblay, Stéphan",M,37,1973,2000,27,18-30
4601,"Bains, Navdeep Singh",M,38,1977,2004,27,18-30
4602,"Poilievre, Pierre",M,39,1979,2006,27,18-30
4603,"Scheer, Andrew",M,39,1979,2006,27,18-30
4604,"Blanchette-Lamothe, Lysane",F,41,1984,2011,27,18-30
4605,"Brosseau, Ruth Ellen",F,41,1984,2011,27,18-30
4606,"Doré Lefebvre, Rosane",F,41,1984,2011,27,18-30
4607,"Latendresse, Alexandrine",F,41,1984,2011,27,18-30
4608,"Tremblay, Jonathan",M,41,1984,2011,27,18-30
4609,"Barsalou-Duval, Xavier",M,42,1988,2015,27,18-30
4610,"Dubé, Matthew",M,42,1988,2015,27,18-30
4611,"Fortin, André-Gilles",M,31,1943,1979,36,31-40
4612,"Murta, Jack Burnett",M,31,1943,1979,36,31-40
4613,"Lachance, Claude-André",M,32,1954,1980,26,18-30
4614,"Tobin, Brian Vincent",M,32,1954,1980,26,18-30
4615,"Charest, Jean J.",M,33,1958,1984,26,18-30
4616,"Jaffer, Rahim",M,36,1971,1997,26,18-30
4617,"Harrison, Jeremy",M,38,1978,2004,26,18-30
4618,"Ashton, Niki",F,40,1982,2008,26,18-30
4619,"Michaud, Élaine",F,41,1985,2011,26,18-30
4620,"Morin, Dany",M,41,1985,2011,26,18-30
4621,"Morin, Isabelle",F,41,1985,2011,26,18-30
4622,"Morin, Marie-Claude",F,41,1985,2011,26,18-30
4623,"Khera, Kamal",F,42,1989,2015,26,18-30
4624,"Qaqqaq, Mumilaaq",F,43,1993,2019,26,18-30
4625,"Symes, Reginald Cyril",M,31,1943,1979,36,31-40
4626,"Breau, Herb",M,31,1944,1979,35,31-40
4627,"Roberts, John (Moody)",M,32,1955,1980,25,18-30
4628,"Gormley, John Kenneth",M,33,1959,1984,25,18-30
4629,"Anders, Rob",M,36,1972,1997,25,18-30
4630,"Hill, Grant",M,36,1972,1997,25,18-30
4631,"Poilievre, Pierre",M,38,1979,2004,25,18-30
4632,"Scheer, Andrew",M,38,1979,2004,25,18-30
4633,"Lambropoulos, Emmanuella",F,42,1990,2015,25,18-30
4634,"Olivier, Joseph Mario Jacques",M,31,1944,1979,35,31-40
4635,"Lapierre, Jean-C.",M,32,1956,1980,24,18-30
4636,"Jacques, Carole",F,33,1960,1984,24,18-30
4637,"Tremblay, Stéphan",M,36,1973,1997,24,18-30
4638,"Moore, James",M,37,1976,2000,24,18-30
4639,"Dusseault, Pierre-Luc",M,42,1991,2015,24,18-30
4640,"Lloyd, Dane",M,42,1991,2015,24,18-30
4641,"Brien, Pierre",M,35,1970,1993,23,18-30
4642,"Dubé, Matthew",M,41,1988,2011,23,18-30
4643,"Péclet, Ève",F,41,1988,2011,23,18-30
4644,"Nystrom, Lorne Edmund",M,31,1946,1979,33,31-40
4645,"Knight, William George",M,31,1947,1979,32,31-40
4646,"Schellenberger, Stanley Kenneth",M,31,1948,1979,31,31-40
4647,"Freeman, Mylène",F,41,1989,2011,22,18-30
4648,"O'Sullivan, Sean Patrick",M,31,1952,1979,27,18-30
4649,"Hill, Grant",M,35,1972,1993,21,18-30
4650,"Dufour, Nicolas",M,40,1987,2008,21,18-30
4651,"Borg, Charmaine",F,41,1990,2011,21,18-30
4652,"Liu, Laurin",F,41,1990,2011,21,18-30
4653,"Melillo, Eric",M,43,1998,2019,21,18-30
4654,"Tremblay, Stéphan",M,35,1973,1993,20,18-30
4655,"Dusseault, Pierre-Luc",M,41,1991,2011,20,18-30
